GAAAGTACTTC -> AAAGTACTTCA
AAAGTACTTCA -> AAGTACTTCAT
AAGTACTTCAT -> AGTACTTCATA
AGTACTTCATA -> GTACTTCATAT
GTACTTCATAT -> TACTTCATATC
TACTTCATATC -> ACTTCATATCC
ACTTCATATCC -> CTTCATATCCA
CTTCATATCCA -> TTCATATCCAC
TTCATATCCAC -> TCATATCCACA
TCATATCCACA -> CATATCCACAT
CATATCCACAT -> ATATCCACATG
ATATCCACATG -> TATCCACATGG
TATCCACATGG -> ATCCACATGGA
ATCCACATGGA -> TCCACATGGAA
TCCACATGGAA -> CCACATGGAAG
CCACATGGAAG -> CACATGGAAGG
CACATGGAAGG -> ACATGGAAGGG
ACATGGAAGGG -> CATGGAAGGGC
CATGGAAGGGC -> ATGGAAGGGCT
ATGGAAGGGCT -> TGGAAGGGCTT
TGGAAGGGCTT -> GGAAGGGCTTG
GGAAGGGCTTG -> GAAGGGCTTGG
GAAGGGCTTGG -> AAGGGCTTGGT
AAGGGCTTGGT -> AGGGCTTGGTT
AGGGCTTGGTT -> GGGCTTGGTTT
GGGCTTGGTTT -> GGCTTGGTTTC
GGCTTGGTTTC -> GCTTGGTTTCC
GCTTGGTTTCC -> CTTGGTTTCCC
CTTGGTTTCCC -> TTGGTTTCCCC
TTGGTTTCCCC -> TGGTTTCCCCC
TGGTTTCCCCC -> GGTTTCCCCCC
GGTTTCCCCCC -> GTTTCCCCCCT
GTTTCCCCCCT -> TTTCCCCCCTC
TTTCCCCCCTC -> TTCCCCCCTCC
TTCCCCCCTCC -> TCCCCCCTCCG
TCCCCCCTCCG -> CCCCCCTCCGA
CCCCCCTCCGA -> CCCCCTCCGAG
CCCCCTCCGAG -> CCCCTCCGAGG
CCCCTCCGAGG -> CCCTCCGAGGG
CCCTCCGAGGG -> CCTCCGAGGGT
CCTCCGAGGGT -> CTCCGAGGGTG
CTCCGAGGGTG -> TCCGAGGGTGC
TCCGAGGGTGC -> CCGAGGGTGCT
CCGAGGGTGCT -> CGAGGGTGCTG
CGAGGGTGCTG -> GAGGGTGCTGC
GAGGGTGCTGC -> AGGGTGCTGCC
AGGGTGCTGCC -> GGGTGCTGCCT
GGGTGCTGCCT -> GGTGCTGCCTT
GGTGCTGCCTT -> GTGCTGCCTTT
GTGCTGCCTTT -> TGCTGCCTTTA
TGCTGCCTTTA -> GCTGCCTTTAG
GCTGCCTTTAG -> CTGCCTTTAGC
CTGCCTTTAGC -> TGCCTTTAGCA
TGCCTTTAGCA -> GCCTTTAGCAG
GCCTTTAGCAG -> CCTTTAGCAGT
CCTTTAGCAGT -> CTTTAGCAGTC
CTTTAGCAGTC -> TTTAGCAGTCA
TTTAGCAGTCA -> TTAGCAGTCAG
TTAGCAGTCAG -> TAGCAGTCAGA
TAGCAGTCAGA -> AGCAGTCAGAA
AGCAGTCAGAA -> GCAGTCAGAAT
GCAGTCAGAAT -> CAGTCAGAATC
CAGTCAGAATC -> AGTCAGAATCG
AGTCAGAATCG -> GTCAGAATCGA
GTCAGAATCGA -> TCAGAATCGAG
TCAGAATCGAG -> CAGAATCGAGA
CAGAATCGAGA -> AGAATCGAGAT
AGAATCGAGAT -> GAATCGAGATG
GAATCGAGATG -> AATCGAGATGG
AATCGAGATGG -> ATCGAGATGGA
ATCGAGATGGA -> TCGAGATGGAC
TCGAGATGGAC -> CGAGATGGACT
CGAGATGGACT -> GAGATGGACTA
GAGATGGACTA -> AGATGGACTAT
AGATGGACTAT -> GATGGACTATA
GATGGACTATA -> ATGGACTATAA
ATGGACTATAA -> TGGACTATAAG
TGGACTATAAG -> GGACTATAAGC
GGACTATAAGC -> GACTATAAGCG
GACTATAAGCG -> ACTATAAGCGG
ACTATAAGCGG -> CTATAAGCGGT
CTATAAGCGGT -> TATAAGCGGTT
TATAAGCGGTT -> ATAAGCGGTTA
ATAAGCGGTTA -> TAAGCGGTTAC
TAAGCGGTTAC -> AAGCGGTTACA
AAGCGGTTACA -> AGCGGTTACAG
AGCGGTTACAG -> GCGGTTACAGA
GCGGTTACAGA -> CGGTTACAGAT
CGGTTACAGAT -> GGTTACAGATG
GGTTACAGATG -> GTTACAGATGT
GTTACAGATGT -> TTACAGATGTC
TTACAGATGTC -> TACAGATGTCG
TACAGATGTCG -> ACAGATGTCGA
ACAGATGTCGA -> CAGATGTCGAA
CAGATGTCGAA -> AGATGTCGAAT
AGATGTCGAAT -> GATGTCGAATA
GATGTCGAATA -> ATGTCGAATAG
ATGTCGAATAG -> TGTCGAATAGC
TGTCGAATAGC -> GTCGAATAGCC
GTCGAATAGCC -> TCGAATAGCCT
TCGAATAGCCT -> CGAATAGCCTG
CGAATAGCCTG -> GAATAGCCTGG
GAATAGCCTGG -> AATAGCCTGGT
AATAGCCTGGT -> ATAGCCTGGTT
ATAGCCTGGTT -> TAGCCTGGTTG
TAGCCTGGTTG -> AGCCTGGTTGG
AGCCTGGTTGG -> GCCTGGTTGGC
GCCTGGTTGGC -> CCTGGTTGGCG
CCTGGTTGGCG -> CTGGTTGGCGC
CTGGTTGGCGC -> TGGTTGGCGCC
TGGTTGGCGCC -> GGTTGGCGCCC
GGTTGGCGCCC -> GTTGGCGCCCT
GTTGGCGCCCT -> TTGGCGCCCTA
TTGGCGCCCTA -> TGGCGCCCTAC
TGGCGCCCTAC -> GGCGCCCTACC
GGCGCCCTACC -> GCGCCCTACCA
GCGCCCTACCA -> CGCCCTACCAT
CGCCCTACCAT -> GCCCTACCATC
GCCCTACCATC -> CCCTACCATCC
CCCTACCATCC -> CCTACCATCCC
CCTACCATCCC -> CTACCATCCCG
CTACCATCCCG -> TACCATCCCGG
TACCATCCCGG -> ACCATCCCGGC
ACCATCCCGGC -> CCATCCCGGCA
CCATCCCGGCA -> CATCCCGGCAC
CATCCCGGCAC -> ATCCCGGCACT
ATCCCGGCACT -> TCCCGGCACTC
TCCCGGCACTC -> CCCGGCACTCG
CCCGGCACTCG -> CCGGCACTCGA
CCGGCACTCGA -> CGGCACTCGAC
CGGCACTCGAC -> GGCACTCGACT
GGCACTCGACT -> GCACTCGACTC
GCACTCGACTC -> CACTCGACTCG
CACTCGACTCG -> ACTCGACTCGT
ACTCGACTCGT -> CTCGACTCGTA
CTCGACTCGTA -> TCGACTCGTAT
TCGACTCGTAT -> CGACTCGTATG
CGACTCGTATG -> GACTCGTATGT
GACTCGTATGT -> ACTCGTATGTC
ACTCGTATGTC -> CTCGTATGTCC
CTCGTATGTCC -> TCGTATGTCCT
TCGTATGTCCT -> CGTATGTCCTT
CGTATGTCCTT -> GTATGTCCTTA
GTATGTCCTTA -> TATGTCCTTAA
TATGTCCTTAA -> ATGTCCTTAAG
ATGTCCTTAAG -> TGTCCTTAAGT
TGTCCTTAAGT -> GTCCTTAAGTA
GTCCTTAAGTA -> TCCTTAAGTAC
TCCTTAAGTAC -> CCTTAAGTACG
CCTTAAGTACG -> CTTAAGTACGC
CTTAAGTACGC -> TTAAGTACGCA
TTAAGTACGCA -> TAAGTACGCAA
TAAGTACGCAA -> AAGTACGCAAA
AAGTACGCAAA -> AGTACGCAAAG
AGTACGCAAAG -> GTACGCAAAGT
GTACGCAAAGT -> TACGCAAAGTC
TACGCAAAGTC -> ACGCAAAGTCT
ACGCAAAGTCT -> CGCAAAGTCTC
CGCAAAGTCTC -> GCAAAGTCTCT
GCAAAGTCTCT -> CAAAGTCTCTT
CAAAGTCTCTT -> AAAGTCTCTTA
AAAGTCTCTTA -> AAGTCTCTTAG
AAGTCTCTTAG -> AGTCTCTTAGA
AGTCTCTTAGA -> GTCTCTTAGAA
GTCTCTTAGAA -> TCTCTTAGAAG
TCTCTTAGAAG -> CTCTTAGAAGT
CTCTTAGAAGT -> TCTTAGAAGTG
TCTTAGAAGTG -> CTTAGAAGTGT
CTTAGAAGTGT -> TTAGAAGTGTA
TTAGAAGTGTA -> TAGAAGTGTAG
TAGAAGTGTAG -> AGAAGTGTAGC
AGAAGTGTAGC -> GAAGTGTAGCC
GAAGTGTAGCC -> AAGTGTAGCCG
AAGTGTAGCCG -> AGTGTAGCCGT
AGTGTAGCCGT -> GTGTAGCCGTC
GTGTAGCCGTC -> TGTAGCCGTCG
TGTAGCCGTCG -> GTAGCCGTCGC
GTAGCCGTCGC -> TAGCCGTCGCT
TAGCCGTCGCT -> AGCCGTCGCTT
AGCCGTCGCTT -> GCCGTCGCTTC
GCCGTCGCTTC -> CCGTCGCTTCT
CCGTCGCTTCT -> CGTCGCTTCTA
CGTCGCTTCTA -> GTCGCTTCTAT
GTCGCTTCTAT -> TCGCTTCTATA
TCGCTTCTATA -> CGCTTCTATAC
CGCTTCTATAC -> GCTTCTATACA
GCTTCTATACA -> CTTCTATACAC
CTTCTATACAC -> TTCTATACACC
TTCTATACACC -> TCTATACACCG
TCTATACACCG -> CTATACACCGT
CTATACACCGT -> TATACACCGTA
TATACACCGTA -> ATACACCGTAA
ATACACCGTAA -> TACACCGTAAG
TACACCGTAAG -> ACACCGTAAGG
ACACCGTAAGG -> CACCGTAAGGG
CACCGTAAGGG -> ACCGTAAGGGC
ACCGTAAGGGC -> CCGTAAGGGCA
CCGTAAGGGCA -> CGTAAGGGCAG
CGTAAGGGCAG -> GTAAGGGCAGT
GTAAGGGCAGT -> TAAGGGCAGTA
TAAGGGCAGTA -> AAGGGCAGTAA
AAGGGCAGTAA -> AGGGCAGTAAT
AGGGCAGTAAT -> GGGCAGTAATG
GGGCAGTAATG -> GGCAGTAATGA
GGCAGTAATGA -> GCAGTAATGAC
GCAGTAATGAC -> CAGTAATGACG
CAGTAATGACG -> AGTAATGACGC
AGTAATGACGC -> GTAATGACGCC
GTAATGACGCC -> TAATGACGCCG
TAATGACGCCG -> AATGACGCCGA
AATGACGCCGA -> ATGACGCCGAT
ATGACGCCGAT -> TGACGCCGATT
TGACGCCGATT -> GACGCCGATTC
GACGCCGATTC -> ACGCCGATTCA
ACGCCGATTCA -> CGCCGATTCAG
CGCCGATTCAG -> GCCGATTCAGA
GCCGATTCAGA -> CCGATTCAGAG
CCGATTCAGAG -> CGATTCAGAGC
CGATTCAGAGC -> GATTCAGAGCG
GATTCAGAGCG -> ATTCAGAGCGA
ATTCAGAGCGA -> TTCAGAGCGAG
TTCAGAGCGAG -> TCAGAGCGAGG
TCAGAGCGAGG -> CAGAGCGAGGT
CAGAGCGAGGT -> AGAGCGAGGTA
AGAGCGAGGTA -> GAGCGAGGTAC
GAGCGAGGTAC -> AGCGAGGTACG
AGCGAGGTACG -> GCGAGGTACGC
GCGAGGTACGC -> CGAGGTACGCC
CGAGGTACGCC -> GAGGTACGCCG
GAGGTACGCCG -> AGGTACGCCGG
AGGTACGCCGG -> GGTACGCCGGA
GGTACGCCGGA -> GTACGCCGGAC
GTACGCCGGAC -> TACGCCGGACC
TACGCCGGACC -> ACGCCGGACCG
ACGCCGGACCG -> CGCCGGACCGT
CGCCGGACCGT -> GCCGGACCGTC
GCCGGACCGTC -> CCGGACCGTCC
CCGGACCGTCC -> CGGACCGTCCA
CGGACCGTCCA -> GGACCGTCCAA
GGACCGTCCAA -> GACCGTCCAAC
GACCGTCCAAC -> ACCGTCCAACA
ACCGTCCAACA -> CCGTCCAACAG
CCGTCCAACAG -> CGTCCAACAGA
CGTCCAACAGA -> GTCCAACAGAA
GTCCAACAGAA -> TCCAACAGAAC
TCCAACAGAAC -> CCAACAGAACC
CCAACAGAACC -> CAACAGAACCC
CAACAGAACCC -> AACAGAACCCA
AACAGAACCCA -> ACAGAACCCAA
ACAGAACCCAA -> CAGAACCCAAC
CAGAACCCAAC -> AGAACCCAACA
AGAACCCAACA -> GAACCCAACAC
GAACCCAACAC -> AACCCAACACT
AACCCAACACT -> ACCCAACACTC
ACCCAACACTC -> CCCAACACTCT
CCCAACACTCT -> CCAACACTCTG
CCAACACTCTG -> CAACACTCTGA
CAACACTCTGA -> AACACTCTGAC
AACACTCTGAC -> ACACTCTGACC
ACACTCTGACC -> CACTCTGACCC
CACTCTGACCC -> ACTCTGACCCT
ACTCTGACCCT -> CTCTGACCCTC
CTCTGACCCTC -> TCTGACCCTCC
TCTGACCCTCC -> CTGACCCTCCT
CTGACCCTCCT -> TGACCCTCCTT
TGACCCTCCTT -> GACCCTCCTTA
GACCCTCCTTA -> ACCCTCCTTAT
ACCCTCCTTAT -> CCCTCCTTATG
CCCTCCTTATG -> CCTCCTTATGA
CCTCCTTATGA -> CTCCTTATGAG
CTCCTTATGAG -> TCCTTATGAGA
TCCTTATGAGA -> CCTTATGAGAG
CCTTATGAGAG -> CTTATGAGAGC
CTTATGAGAGC -> TTATGAGAGCG
TTATGAGAGCG -> TATGAGAGCGG
TATGAGAGCGG -> ATGAGAGCGGA
ATGAGAGCGGA -> TGAGAGCGGAT
TGAGAGCGGAT -> GAGAGCGGATG
GAGAGCGGATG -> AGAGCGGATGT
AGAGCGGATGT -> GAGCGGATGTT
GAGCGGATGTT -> AGCGGATGTTC
AGCGGATGTTC -> GCGGATGTTCG
GCGGATGTTCG -> CGGATGTTCGT
CGGATGTTCGT -> GGATGTTCGTC
GGATGTTCGTC -> GATGTTCGTCC
GATGTTCGTCC -> ATGTTCGTCCA
ATGTTCGTCCA -> TGTTCGTCCAA
TGTTCGTCCAA -> GTTCGTCCAAT
GTTCGTCCAAT -> TTCGTCCAATT
TTCGTCCAATT -> TCGTCCAATTA
TCGTCCAATTA -> CGTCCAATTAG
CGTCCAATTAG -> GTCCAATTAGC
GTCCAATTAGC -> TCCAATTAGCA
TCCAATTAGCA -> CCAATTAGCAA
CCAATTAGCAA -> CAATTAGCAAA
CAATTAGCAAA -> AATTAGCAAAC
AATTAGCAAAC -> ATTAGCAAACA
ATTAGCAAACA -> TTAGCAAACAA
TTAGCAAACAA -> TAGCAAACAAG
TAGCAAACAAG -> AGCAAACAAGA
AGCAAACAAGA -> GCAAACAAGAT
GCAAACAAGAT -> CAAACAAGATA
CAAACAAGATA -> AAACAAGATAT
AAACAAGATAT -> AACAAGATATT
AACAAGATATT -> ACAAGATATTC
ACAAGATATTC -> CAAGATATTCG
CAAGATATTCG -> AAGATATTCGA
AAGATATTCGA -> AGATATTCGAG
AGATATTCGAG -> GATATTCGAGC
GATATTCGAGC -> ATATTCGAGCT
ATATTCGAGCT -> TATTCGAGCTC
TATTCGAGCTC -> ATTCGAGCTCT
ATTCGAGCTCT -> TTCGAGCTCTT
TTCGAGCTCTT -> TCGAGCTCTTG
TCGAGCTCTTG -> CGAGCTCTTGA
CGAGCTCTTGA -> GAGCTCTTGAT
GAGCTCTTGAT -> AGCTCTTGATA
AGCTCTTGATA -> GCTCTTGATAA
GCTCTTGATAA -> CTCTTGATAAT
CTCTTGATAAT -> TCTTGATAATG
TCTTGATAATG -> CTTGATAATGG
CTTGATAATGG -> TTGATAATGGG
TTGATAATGGG -> TGATAATGGGA
TGATAATGGGA -> GATAATGGGAA
GATAATGGGAA -> ATAATGGGAAG
ATAATGGGAAG -> TAATGGGAAGT
TAATGGGAAGT -> AATGGGAAGTA
AATGGGAAGTA -> ATGGGAAGTAA
ATGGGAAGTAA -> TGGGAAGTAAA
TGGGAAGTAAA -> GGGAAGTAAAA
GGGAAGTAAAA -> GGAAGTAAAAG
GGAAGTAAAAG -> GAAGTAAAAGA
GAAGTAAAAGA -> AAGTAAAAGAG
AAGTAAAAGAG -> AGTAAAAGAGA
AGTAAAAGAGA -> GTAAAAGAGAC
GTAAAAGAGAC -> TAAAAGAGACC
TAAAAGAGACC -> AAAAGAGACCT
AAAAGAGACCT -> AAAGAGACCTC
AAAGAGACCTC -> AAGAGACCTCC
AAGAGACCTCC -> AGAGACCTCCT
AGAGACCTCCT -> GAGACCTCCTA
GAGACCTCCTA -> AGACCTCCTAG
AGACCTCCTAG -> GACCTCCTAGG
GACCTCCTAGG -> ACCTCCTAGGA
ACCTCCTAGGA -> CCTCCTAGGAA
CCTCCTAGGAA -> CTCCTAGGAAA
CTCCTAGGAAA -> TCCTAGGAAAT
TCCTAGGAAAT -> CCTAGGAAATG
CCTAGGAAATG -> CTAGGAAATGT
CTAGGAAATGT -> TAGGAAATGTT
TAGGAAATGTT -> AGGAAATGTTG
AGGAAATGTTG -> GGAAATGTTGA
GGAAATGTTGA -> GAAATGTTGAG
GAAATGTTGAG -> AAATGTTGAGC
AAATGTTGAGC -> AATGTTGAGCT
AATGTTGAGCT -> ATGTTGAGCTA
ATGTTGAGCTA -> TGTTGAGCTAC
TGTTGAGCTAC -> GTTGAGCTACA
GTTGAGCTACA -> TTGAGCTACAC
TTGAGCTACAC -> TGAGCTACACG
TGAGCTACACG -> GAGCTACACGA
GAGCTACACGA -> AGCTACACGAT
AGCTACACGAT -> GCTACACGATA
GCTACACGATA -> CTACACGATAT
CTACACGATAT -> TACACGATATG
TACACGATATG -> ACACGATATGA
ACACGATATGA -> CACGATATGAA
CACGATATGAA -> ACGATATGAAA
ACGATATGAAA -> CGATATGAAAT
CGATATGAAAT -> GATATGAAATG
GATATGAAATG -> ATATGAAATGC
ATATGAAATGC -> TATGAAATGCA
TATGAAATGCA -> ATGAAATGCAG
ATGAAATGCAG -> TGAAATGCAGT
TGAAATGCAGT -> GAAATGCAGTG
GAAATGCAGTG -> AAATGCAGTGA
AAATGCAGTGA -> AATGCAGTGAG
AATGCAGTGAG -> ATGCAGTGAGA
ATGCAGTGAGA -> TGCAGTGAGAC
TGCAGTGAGAC -> GCAGTGAGACG
GCAGTGAGACG -> CAGTGAGACGA
CAGTGAGACGA -> AGTGAGACGAA
AGTGAGACGAA -> GTGAGACGAAC
GTGAGACGAAC -> TGAGACGAACC
TGAGACGAACC -> GAGACGAACCA
GAGACGAACCA -> AGACGAACCAG
AGACGAACCAG -> GACGAACCAGA
GACGAACCAGA -> ACGAACCAGAA
ACGAACCAGAA -> CGAACCAGAAA
CGAACCAGAAA -> GAACCAGAAAC
GAACCAGAAAC -> AACCAGAAACT
AACCAGAAACT -> ACCAGAAACTT
ACCAGAAACTT -> CCAGAAACTTT
CCAGAAACTTT -> CAGAAACTTTT
CAGAAACTTTT -> AGAAACTTTTA
AGAAACTTTTA -> GAAACTTTTAG
GAAACTTTTAG -> AAACTTTTAGT
AAACTTTTAGT -> AACTTTTAGTT
AACTTTTAGTT -> ACTTTTAGTTG
ACTTTTAGTTG -> CTTTTAGTTGA
CTTTTAGTTGA -> TTTTAGTTGAA
TTTTAGTTGAA -> TTTAGTTGAAC
TTTAGTTGAAC -> TTAGTTGAACG
TTAGTTGAACG -> TAGTTGAACGT
TAGTTGAACGT -> AGTTGAACGTG
AGTTGAACGTG -> GTTGAACGTGA
GTTGAACGTGA -> TTGAACGTGAC
TTGAACGTGAC -> TGAACGTGACC
TGAACGTGACC -> GAACGTGACCC
GAACGTGACCC -> AACGTGACCCA
AACGTGACCCA -> ACGTGACCCAA
ACGTGACCCAA -> CGTGACCCAAG
CGTGACCCAAG -> GTGACCCAAGA
GTGACCCAAGA -> TGACCCAAGAG
TGACCCAAGAG -> GACCCAAGAGC
GACCCAAGAGC -> ACCCAAGAGCG
ACCCAAGAGCG -> CCCAAGAGCGC
CCCAAGAGCGC -> CCAAGAGCGCT
CCAAGAGCGCT -> CAAGAGCGCTG
CAAGAGCGCTG -> AAGAGCGCTGT
AAGAGCGCTGT -> AGAGCGCTGTC
AGAGCGCTGTC -> GAGCGCTGTCC
GAGCGCTGTCC -> AGCGCTGTCCC
AGCGCTGTCCC -> GCGCTGTCCCC
GCGCTGTCCCC -> CGCTGTCCCCA
CGCTGTCCCCA -> GCTGTCCCCAT
GCTGTCCCCAT -> CTGTCCCCATA
CTGTCCCCATA -> TGTCCCCATAT
TGTCCCCATAT -> GTCCCCATATA
GTCCCCATATA -> TCCCCATATAC
TCCCCATATAC -> CCCCATATACC
CCCCATATACC -> CCCATATACCC
CCCATATACCC -> CCATATACCCG
CCATATACCCG -> CATATACCCGA
CATATACCCGA -> ATATACCCGAA
ATATACCCGAA -> TATACCCGAAG
TATACCCGAAG -> ATACCCGAAGG
ATACCCGAAGG -> TACCCGAAGGT
TACCCGAAGGT -> ACCCGAAGGTT
ACCCGAAGGTT -> CCCGAAGGTTC
CCCGAAGGTTC -> CCGAAGGTTCT
CCGAAGGTTCT -> CGAAGGTTCTT
CGAAGGTTCTT -> GAAGGTTCTTC
GAAGGTTCTTC -> AAGGTTCTTCG
AAGGTTCTTCG -> AGGTTCTTCGA
AGGTTCTTCGA -> GGTTCTTCGAG
GGTTCTTCGAG -> GTTCTTCGAGG
GTTCTTCGAGG -> TTCTTCGAGGG
TTCTTCGAGGG -> TCTTCGAGGGA
TCTTCGAGGGA -> CTTCGAGGGAG
CTTCGAGGGAG -> TTCGAGGGAGG
TTCGAGGGAGG -> TCGAGGGAGGT
TCGAGGGAGGT -> CGAGGGAGGTA
CGAGGGAGGTA -> GAGGGAGGTAG
GAGGGAGGTAG -> AGGGAGGTAGT
AGGGAGGTAGT -> GGGAGGTAGTT
GGGAGGTAGTT -> GGAGGTAGTTC
GGAGGTAGTTC -> GAGGTAGTTCT
GAGGTAGTTCT -> AGGTAGTTCTC
AGGTAGTTCTC -> GGTAGTTCTCT
GGTAGTTCTCT -> GTAGTTCTCTG
GTAGTTCTCTG -> TAGTTCTCTGC
TAGTTCTCTGC -> AGTTCTCTGCG
AGTTCTCTGCG -> GTTCTCTGCGT
GTTCTCTGCGT -> TTCTCTGCGTT
TTCTCTGCGTT -> TCTCTGCGTTC
TCTCTGCGTTC -> CTCTGCGTTCA
CTCTGCGTTCA -> TCTGCGTTCAG
TCTGCGTTCAG -> CTGCGTTCAGG
CTGCGTTCAGG -> TGCGTTCAGGG
TGCGTTCAGGG -> GCGTTCAGGGG
GCGTTCAGGGG -> CGTTCAGGGGA
CGTTCAGGGGA -> GTTCAGGGGAG
GTTCAGGGGAG -> TTCAGGGGAGC
TTCAGGGGAGC -> TCAGGGGAGCG
TCAGGGGAGCG -> CAGGGGAGCGC
CAGGGGAGCGC -> AGGGGAGCGCG
AGGGGAGCGCG -> GGGGAGCGCGA
GGGGAGCGCGA -> GGGAGCGCGAC
GGGAGCGCGAC -> GGAGCGCGACT
GGAGCGCGACT -> GAGCGCGACTC
GAGCGCGACTC -> AGCGCGACTCA
AGCGCGACTCA -> GCGCGACTCAC
GCGCGACTCAC -> CGCGACTCACT
CGCGACTCACT -> GCGACTCACTG
GCGACTCACTG -> CGACTCACTGA
CGACTCACTGA -> GACTCACTGAT
GACTCACTGAT -> ACTCACTGATT
ACTCACTGATT -> CTCACTGATTA
CTCACTGATTA -> TCACTGATTAG
TCACTGATTAG -> CACTGATTAGT
CACTGATTAGT -> ACTGATTAGTG
ACTGATTAGTG -> CTGATTAGTGT
CTGATTAGTGT -> TGATTAGTGTC
TGATTAGTGTC -> GATTAGTGTCT
GATTAGTGTCT -> ATTAGTGTCTA
ATTAGTGTCTA -> TTAGTGTCTAG
TTAGTGTCTAG -> TAGTGTCTAGG
TAGTGTCTAGG -> AGTGTCTAGGT
AGTGTCTAGGT -> GTGTCTAGGTG
GTGTCTAGGTG -> TGTCTAGGTGC
TGTCTAGGTGC -> GTCTAGGTGCG
GTCTAGGTGCG -> TCTAGGTGCGT
TCTAGGTGCGT -> CTAGGTGCGTC
CTAGGTGCGTC -> TAGGTGCGTCG
TAGGTGCGTCG -> AGGTGCGTCGA
AGGTGCGTCGA -> GGTGCGTCGAG
GGTGCGTCGAG -> GTGCGTCGAGG
GTGCGTCGAGG -> TGCGTCGAGGG
TGCGTCGAGGG -> GCGTCGAGGGT
GCGTCGAGGGT -> CGTCGAGGGTT
CGTCGAGGGTT -> GTCGAGGGTTT
GTCGAGGGTTT -> TCGAGGGTTTG
TCGAGGGTTTG -> CGAGGGTTTGT
CGAGGGTTTGT -> GAGGGTTTGTC
GAGGGTTTGTC -> AGGGTTTGTCA
AGGGTTTGTCA -> GGGTTTGTCAG
GGGTTTGTCAG -> GGTTTGTCAGA
GGTTTGTCAGA -> GTTTGTCAGAA
GTTTGTCAGAA -> TTTGTCAGAAA
TTTGTCAGAAA -> TTGTCAGAAAT
TTGTCAGAAAT -> TGTCAGAAATC
TGTCAGAAATC -> GTCAGAAATCT
GTCAGAAATCT -> TCAGAAATCTT
TCAGAAATCTT -> CAGAAATCTTA
CAGAAATCTTA -> AGAAATCTTAA
AGAAATCTTAA -> GAAATCTTAAT
GAAATCTTAAT -> AAATCTTAATA
AAATCTTAATA -> AATCTTAATAA
AATCTTAATAA -> ATCTTAATAAA
ATCTTAATAAA -> TCTTAATAAAA
TCTTAATAAAA -> CTTAATAAAAG
CTTAATAAAAG -> TTAATAAAAGT
TTAATAAAAGT -> TAATAAAAGTA
TAATAAAAGTA -> AATAAAAGTAC
AATAAAAGTAC -> ATAAAAGTACC
ATAAAAGTACC -> TAAAAGTACCT
TAAAAGTACCT -> AAAAGTACCTC
AAAAGTACCTC -> AAAGTACCTCT
AAAGTACCTCT -> AAGTACCTCTT
AAGTACCTCTT -> AGTACCTCTTT
AGTACCTCTTT -> GTACCTCTTTG
GTACCTCTTTG -> TACCTCTTTGA
TACCTCTTTGA -> ACCTCTTTGAT
ACCTCTTTGAT -> CCTCTTTGATC
CCTCTTTGATC -> CTCTTTGATCA
CTCTTTGATCA -> TCTTTGATCAC
TCTTTGATCAC -> CTTTGATCACG
CTTTGATCACG -> TTTGATCACGT
TTTGATCACGT -> TTGATCACGTC
TTGATCACGTC -> TGATCACGTCA
TGATCACGTCA -> GATCACGTCAG
GATCACGTCAG -> ATCACGTCAGA
ATCACGTCAGA -> TCACGTCAGAT
TCACGTCAGAT -> CACGTCAGATT
CACGTCAGATT -> ACGTCAGATTA
ACGTCAGATTA -> CGTCAGATTAG
CGTCAGATTAG -> GTCAGATTAGA
GTCAGATTAGA -> TCAGATTAGAA
TCAGATTAGAA -> CAGATTAGAAC
CAGATTAGAAC -> AGATTAGAACG
AGATTAGAACG -> GATTAGAACGG
GATTAGAACGG -> ATTAGAACGGA
ATTAGAACGGA -> TTAGAACGGAA
TTAGAACGGAA -> TAGAACGGAAC
TAGAACGGAAC -> AGAACGGAACC
AGAACGGAACC -> GAACGGAACCT
GAACGGAACCT -> AACGGAACCTC
AACGGAACCTC -> ACGGAACCTCA
ACGGAACCTCA -> CGGAACCTCAT
CGGAACCTCAT -> GGAACCTCATA
GGAACCTCATA -> GAACCTCATAG
GAACCTCATAG -> AACCTCATAGC
AACCTCATAGC -> ACCTCATAGCT
ACCTCATAGCT -> CCTCATAGCTT
CCTCATAGCTT -> CTCATAGCTTT
CTCATAGCTTT -> TCATAGCTTTG
TCATAGCTTTG -> CATAGCTTTGA
CATAGCTTTGA -> ATAGCTTTGAA
ATAGCTTTGAA -> TAGCTTTGAAC
TAGCTTTGAAC -> AGCTTTGAACC
AGCTTTGAACC -> GCTTTGAACCT
GCTTTGAACCT -> CTTTGAACCTC
CTTTGAACCTC -> TTTGAACCTCT
TTTGAACCTCT -> TTGAACCTCTG
TTGAACCTCTG -> TGAACCTCTGT
TGAACCTCTGT -> GAACCTCTGTG
GAACCTCTGTG -> AACCTCTGTGC
AACCTCTGTGC -> ACCTCTGTGCC
ACCTCTGTGCC -> CCTCTGTGCCT
CCTCTGTGCCT -> CTCTGTGCCTC
CTCTGTGCCTC -> TCTGTGCCTCA
TCTGTGCCTCA -> CTGTGCCTCAT
CTGTGCCTCAT -> TGTGCCTCATG
TGTGCCTCATG -> GTGCCTCATGT
GTGCCTCATGT -> TGCCTCATGTC
TGCCTCATGTC -> GCCTCATGTCT
GCCTCATGTCT -> CCTCATGTCTT
CCTCATGTCTT -> CTCATGTCTTT
CTCATGTCTTT -> TCATGTCTTTC
TCATGTCTTTC -> CATGTCTTTCA
CATGTCTTTCA -> ATGTCTTTCAC
ATGTCTTTCAC -> TGTCTTTCACA
TGTCTTTCACA -> GTCTTTCACAA
GTCTTTCACAA -> TCTTTCACAAT
TCTTTCACAAT -> CTTTCACAATT
CTTTCACAATT -> TTTCACAATTA
TTTCACAATTA -> TTCACAATTAT
TTCACAATTAT -> TCACAATTATC
TCACAATTATC -> CACAATTATCG
CACAATTATCG -> ACAATTATCGT
ACAATTATCGT -> CAATTATCGTA
CAATTATCGTA -> AATTATCGTAC
AATTATCGTAC -> ATTATCGTACC
ATTATCGTACC -> TTATCGTACCT
TTATCGTACCT -> TATCGTACCTA
TATCGTACCTA -> ATCGTACCTAT
ATCGTACCTAT -> TCGTACCTATC
TCGTACCTATC -> CGTACCTATCA
CGTACCTATCA -> GTACCTATCAA
GTACCTATCAA -> TACCTATCAAA
TACCTATCAAA -> ACCTATCAAAC
ACCTATCAAAC -> CCTATCAAACT
CCTATCAAACT -> CTATCAAACTC
CTATCAAACTC -> TATCAAACTCT
TATCAAACTCT -> ATCAAACTCTC
ATCAAACTCTC -> TCAAACTCTCG
TCAAACTCTCG -> CAAACTCTCGT
CAAACTCTCGT -> AAACTCTCGTT
AAACTCTCGTT -> AACTCTCGTTG
AACTCTCGTTG -> ACTCTCGTTGT
ACTCTCGTTGT -> CTCTCGTTGTC
CTCTCGTTGTC -> TCTCGTTGTCG
TCTCGTTGTCG -> CTCGTTGTCGA
CTCGTTGTCGA -> TCGTTGTCGAA
TCGTTGTCGAA -> CGTTGTCGAAC
CGTTGTCGAAC -> GTTGTCGAACT
GTTGTCGAACT -> TTGTCGAACTC
TTGTCGAACTC -> TGTCGAACTCT
TGTCGAACTCT -> GTCGAACTCTT
GTCGAACTCTT -> TCGAACTCTTA
TCGAACTCTTA -> CGAACTCTTAA
CGAACTCTTAA -> GAACTCTTAAT
GAACTCTTAAT -> AACTCTTAATC
AACTCTTAATC -> ACTCTTAATCA
ACTCTTAATCA -> CTCTTAATCAC
CTCTTAATCAC -> TCTTAATCACC
TCTTAATCACC -> CTTAATCACCA
CTTAATCACCA -> TTAATCACCAG
TTAATCACCAG -> TAATCACCAGA
TAATCACCAGA -> AATCACCAGAC
AATCACCAGAC -> ATCACCAGACG
ATCACCAGACG -> TCACCAGACGC
TCACCAGACGC -> CACCAGACGCG
CACCAGACGCG -> ACCAGACGCGA
ACCAGACGCGA -> CCAGACGCGAC
CCAGACGCGAC -> CAGACGCGACT
CAGACGCGACT -> AGACGCGACTG
AGACGCGACTG -> GACGCGACTGA
GACGCGACTGA -> ACGCGACTGAT
ACGCGACTGAT -> CGCGACTGATT
CGCGACTGATT -> GCGACTGATTA
GCGACTGATTA -> CGACTGATTAT
CGACTGATTAT -> GACTGATTATT
GACTGATTATT -> ACTGATTATTT
ACTGATTATTT -> CTGATTATTTG
CTGATTATTTG -> TGATTATTTGA
TGATTATTTGA -> GATTATTTGAG
GATTATTTGAG -> ATTATTTGAGC
ATTATTTGAGC -> TTATTTGAGCA
TTATTTGAGCA -> TATTTGAGCAA
TATTTGAGCAA -> ATTTGAGCAAG
ATTTGAGCAAG -> TTTGAGCAAGG
TTTGAGCAAGG -> TTGAGCAAGGG
TTGAGCAAGGG -> TGAGCAAGGGT
TGAGCAAGGGT -> GAGCAAGGGTG
GAGCAAGGGTG -> AGCAAGGGTGG
AGCAAGGGTGG -> GCAAGGGTGGA
GCAAGGGTGGA -> CAAGGGTGGAT
CAAGGGTGGAT -> AAGGGTGGATT
AAGGGTGGATT -> AGGGTGGATTT
AGGGTGGATTT -> GGGTGGATTTC
GGGTGGATTTC -> GGTGGATTTCC
GGTGGATTTCC -> GTGGATTTCCT
GTGGATTTCCT -> TGGATTTCCTG
TGGATTTCCTG -> GGATTTCCTGT
GGATTTCCTGT -> GATTTCCTGTG
GATTTCCTGTG -> ATTTCCTGTGA
ATTTCCTGTGA -> TTTCCTGTGAG
TTTCCTGTGAG -> TTCCTGTGAGC
TTCCTGTGAGC -> TCCTGTGAGCG
TCCTGTGAGCG -> CCTGTGAGCGT
CCTGTGAGCGT -> CTGTGAGCGTG
CTGTGAGCGTG -> TGTGAGCGTGA
TGTGAGCGTGA -> GTGAGCGTGAT
GTGAGCGTGAT -> TGAGCGTGATA
TGAGCGTGATA -> GAGCGTGATAG
GAGCGTGATAG -> AGCGTGATAGG
AGCGTGATAGG -> GCGTGATAGGG
GCGTGATAGGG -> CGTGATAGGGC
CGTGATAGGGC -> GTGATAGGGCG
GTGATAGGGCG -> TGATAGGGCGT
TGATAGGGCGT -> GATAGGGCGTT
GATAGGGCGTT -> ATAGGGCGTTA
ATAGGGCGTTA -> TAGGGCGTTAA
TAGGGCGTTAA -> AGGGCGTTAAT
AGGGCGTTAAT -> GGGCGTTAATC
GGGCGTTAATC -> GGCGTTAATCC
GGCGTTAATCC -> GCGTTAATCCG
GCGTTAATCCG -> CGTTAATCCGA
CGTTAATCCGA -> GTTAATCCGAG
GTTAATCCGAG -> TTAATCCGAGT
TTAATCCGAGT -> TAATCCGAGTA
TAATCCGAGTA -> AATCCGAGTAG
AATCCGAGTAG -> ATCCGAGTAGC
ATCCGAGTAGC -> TCCGAGTAGCT
TCCGAGTAGCT -> CCGAGTAGCTT
CCGAGTAGCTT -> CGAGTAGCTTT
CGAGTAGCTTT -> GAGTAGCTTTG
GAGTAGCTTTG -> AGTAGCTTTGC
AGTAGCTTTGC -> GTAGCTTTGCC
GTAGCTTTGCC -> TAGCTTTGCCT
TAGCTTTGCCT -> AGCTTTGCCTA
AGCTTTGCCTA -> GCTTTGCCTAA
GCTTTGCCTAA -> CTTTGCCTAAA
CTTTGCCTAAA -> TTTGCCTAAAC
TTTGCCTAAAC -> TTGCCTAAACG
TTGCCTAAACG -> TGCCTAAACGG
TGCCTAAACGG -> GCCTAAACGGC
GCCTAAACGGC -> CCTAAACGGCC
CCTAAACGGCC -> CTAAACGGCCG
CTAAACGGCCG -> TAAACGGCCGT
TAAACGGCCGT -> AAACGGCCGTA
AAACGGCCGTA -> AACGGCCGTAC
AACGGCCGTAC -> ACGGCCGTACA
ACGGCCGTACA -> CGGCCGTACAC
CGGCCGTACAC -> GGCCGTACACT
GGCCGTACACT -> GCCGTACACTA
GCCGTACACTA -> CCGTACACTAA
CCGTACACTAA -> CGTACACTAAA
CGTACACTAAA -> GTACACTAAAG
GTACACTAAAG -> TACACTAAAGT
TACACTAAAGT -> ACACTAAAGTT
ACACTAAAGTT -> CACTAAAGTTT
CACTAAAGTTT -> ACTAAAGTTTT
ACTAAAGTTTT -> CTAAAGTTTTT
CTAAAGTTTTT -> TAAAGTTTTTG
TAAAGTTTTTG -> AAAGTTTTTGG
AAAGTTTTTGG -> AAGTTTTTGGA
AAGTTTTTGGA -> AGTTTTTGGAG
AGTTTTTGGAG -> GTTTTTGGAGG
GTTTTTGGAGG -> TTTTTGGAGGA
TTTTTGGAGGA -> TTTTGGAGGAA
TTTTGGAGGAA -> TTTGGAGGAAC
TTTGGAGGAAC -> TTGGAGGAACT
TTGGAGGAACT -> TGGAGGAACTA
TGGAGGAACTA -> GGAGGAACTAT
GGAGGAACTAT -> GAGGAACTATC
GAGGAACTATC -> AGGAACTATCT
AGGAACTATCT -> GGAACTATCTA
GGAACTATCTA -> GAACTATCTAC
GAACTATCTAC -> AACTATCTACA
AACTATCTACA -> ACTATCTACAG
ACTATCTACAG -> CTATCTACAGC
CTATCTACAGC -> TATCTACAGCT
TATCTACAGCT -> ATCTACAGCTA
ATCTACAGCTA -> TCTACAGCTAC
TCTACAGCTAC -> CTACAGCTACT
CTACAGCTACT -> TACAGCTACTA
TACAGCTACTA -> ACAGCTACTAA
ACAGCTACTAA -> CAGCTACTAAT
CAGCTACTAAT -> AGCTACTAATG
AGCTACTAATG -> GCTACTAATGG
GCTACTAATGG -> CTACTAATGGT
CTACTAATGGT -> TACTAATGGTT
TACTAATGGTT -> ACTAATGGTTT
ACTAATGGTTT -> CTAATGGTTTG
CTAATGGTTTG -> TAATGGTTTGA
TAATGGTTTGA -> AATGGTTTGAT
AATGGTTTGAT -> ATGGTTTGATT
ATGGTTTGATT -> TGGTTTGATTT
TGGTTTGATTT -> GGTTTGATTTG
GGTTTGATTTG -> GTTTGATTTGG
GTTTGATTTGG -> TTTGATTTGGT
TTTGATTTGGT -> TTGATTTGGTT
TTGATTTGGTT -> TGATTTGGTTC
TGATTTGGTTC -> GATTTGGTTCG
GATTTGGTTCG -> ATTTGGTTCGT
ATTTGGTTCGT -> TTTGGTTCGTA
TTTGGTTCGTA -> TTGGTTCGTAA
TTGGTTCGTAA -> TGGTTCGTAAT
TGGTTCGTAAT -> GGTTCGTAATC
GGTTCGTAATC -> GTTCGTAATCG
GTTCGTAATCG -> TTCGTAATCGT
TTCGTAATCGT -> TCGTAATCGTC
TCGTAATCGTC -> CGTAATCGTCT
CGTAATCGTCT -> GTAATCGTCTG
GTAATCGTCTG -> TAATCGTCTGT
TAATCGTCTGT -> AATCGTCTGTC
AATCGTCTGTC -> ATCGTCTGTCC
ATCGTCTGTCC -> TCGTCTGTCCC
TCGTCTGTCCC -> CGTCTGTCCCC
CGTCTGTCCCC -> GTCTGTCCCCC
GTCTGTCCCCC -> TCTGTCCCCCA
TCTGTCCCCCA -> CTGTCCCCCAC
CTGTCCCCCAC -> TGTCCCCCACG
TGTCCCCCACG -> GTCCCCCACGG
GTCCCCCACGG -> TCCCCCACGGC
TCCCCCACGGC -> CCCCCACGGCT
CCCCCACGGCT -> CCCCACGGCTG
CCCCACGGCTG -> CCCACGGCTGA
CCCACGGCTGA -> CCACGGCTGAG
CCACGGCTGAG -> CACGGCTGAGT
CACGGCTGAGT -> ACGGCTGAGTG
ACGGCTGAGTG -> CGGCTGAGTGC
CGGCTGAGTGC -> GGCTGAGTGCC
GGCTGAGTGCC -> GCTGAGTGCCT
GCTGAGTGCCT -> CTGAGTGCCTC
CTGAGTGCCTC -> TGAGTGCCTCC
TGAGTGCCTCC -> GAGTGCCTCCG
GAGTGCCTCCG -> AGTGCCTCCGT
AGTGCCTCCGT -> GTGCCTCCGTC
GTGCCTCCGTC -> TGCCTCCGTCC
TGCCTCCGTCC -> GCCTCCGTCCA
GCCTCCGTCCA -> CCTCCGTCCAG
CCTCCGTCCAG -> CTCCGTCCAGT
CTCCGTCCAGT -> TCCGTCCAGTC
TCCGTCCAGTC -> CCGTCCAGTCA
CCGTCCAGTCA -> CGTCCAGTCAC
CGTCCAGTCAC -> GTCCAGTCACA
GTCCAGTCACA -> TCCAGTCACAG
TCCAGTCACAG -> CCAGTCACAGA
CCAGTCACAGA -> CAGTCACAGAA
CAGTCACAGAA -> AGTCACAGAAT
AGTCACAGAAT -> GTCACAGAATA
GTCACAGAATA -> TCACAGAATAT
TCACAGAATAT -> CACAGAATATT
CACAGAATATT -> ACAGAATATTA
ACAGAATATTA -> CAGAATATTAG
CAGAATATTAG -> AGAATATTAGA
AGAATATTAGA -> GAATATTAGAG
GAATATTAGAG -> AATATTAGAGT
AATATTAGAGT -> ATATTAGAGTA
ATATTAGAGTA -> TATTAGAGTAG
TATTAGAGTAG -> ATTAGAGTAGG
ATTAGAGTAGG -> TTAGAGTAGGT
TTAGAGTAGGT -> TAGAGTAGGTT
TAGAGTAGGTT -> AGAGTAGGTTT
AGAGTAGGTTT -> GAGTAGGTTTA
GAGTAGGTTTA -> AGTAGGTTTAG
AGTAGGTTTAG -> GTAGGTTTAGA
GTAGGTTTAGA -> TAGGTTTAGAG
TAGGTTTAGAG -> AGGTTTAGAGT
AGGTTTAGAGT -> GGTTTAGAGTA
GGTTTAGAGTA -> GTTTAGAGTAA
GTTTAGAGTAA -> TTTAGAGTAAC
TTTAGAGTAAC -> TTAGAGTAACT
TTAGAGTAACT -> TAGAGTAACTT
TAGAGTAACTT -> AGAGTAACTTG
AGAGTAACTTG -> GAGTAACTTGC
GAGTAACTTGC -> AGTAACTTGCA
AGTAACTTGCA -> GTAACTTGCAT
GTAACTTGCAT -> TAACTTGCATA
TAACTTGCATA -> AACTTGCATAC
AACTTGCATAC -> ACTTGCATACG
ACTTGCATACG -> CTTGCATACGG
CTTGCATACGG -> TTGCATACGGG
TTGCATACGGG -> TGCATACGGGG
TGCATACGGGG -> GCATACGGGGG
GCATACGGGGG -> CATACGGGGGA
CATACGGGGGA -> ATACGGGGGAA
ATACGGGGGAA -> TACGGGGGAAA
TACGGGGGAAA -> ACGGGGGAAAT
ACGGGGGAAAT -> CGGGGGAAATA
CGGGGGAAATA -> GGGGGAAATAA
GGGGGAAATAA -> GGGGAAATAAT
GGGGAAATAAT -> GGGAAATAATT
GGGAAATAATT -> GGAAATAATTC
GGAAATAATTC -> GAAATAATTCG
GAAATAATTCG -> AAATAATTCGA
AAATAATTCGA -> AATAATTCGAC
AATAATTCGAC -> ATAATTCGACA
ATAATTCGACA -> TAATTCGACAT
TAATTCGACAT -> AATTCGACATC
AATTCGACATC -> ATTCGACATCT
ATTCGACATCT -> TTCGACATCTT
TTCGACATCTT -> TCGACATCTTT
TCGACATCTTT -> CGACATCTTTG
CGACATCTTTG -> GACATCTTTGG
GACATCTTTGG -> ACATCTTTGGC
ACATCTTTGGC -> CATCTTTGGCG
CATCTTTGGCG -> ATCTTTGGCGC
ATCTTTGGCGC -> TCTTTGGCGCG
TCTTTGGCGCG -> CTTTGGCGCGG
CTTTGGCGCGG -> TTTGGCGCGGC
TTTGGCGCGGC -> TTGGCGCGGCA
TTGGCGCGGCA -> TGGCGCGGCAG
TGGCGCGGCAG -> GGCGCGGCAGC
GGCGCGGCAGC -> GCGCGGCAGCC
GCGCGGCAGCC -> CGCGGCAGCCG
CGCGGCAGCCG -> GCGGCAGCCGA
GCGGCAGCCGA -> CGGCAGCCGAA
CGGCAGCCGAA -> GGCAGCCGAAT
GGCAGCCGAAT -> GCAGCCGAATT
GCAGCCGAATT -> CAGCCGAATTT
CAGCCGAATTT -> AGCCGAATTTC
AGCCGAATTTC -> GCCGAATTTCG
GCCGAATTTCG -> CCGAATTTCGT
CCGAATTTCGT -> CGAATTTCGTT
CGAATTTCGTT -> GAATTTCGTTC
GAATTTCGTTC -> AATTTCGTTCG
AATTTCGTTCG -> ATTTCGTTCGG
ATTTCGTTCGG -> TTTCGTTCGGA
TTTCGTTCGGA -> TTCGTTCGGAC
TTCGTTCGGAC -> TCGTTCGGACC
TCGTTCGGACC -> CGTTCGGACCA
CGTTCGGACCA -> GTTCGGACCAT
GTTCGGACCAT -> TTCGGACCATC
TTCGGACCATC -> TCGGACCATCT
TCGGACCATCT -> CGGACCATCTT
CGGACCATCTT -> GGACCATCTTA
GGACCATCTTA -> GACCATCTTAA
GACCATCTTAA -> ACCATCTTAAA
ACCATCTTAAA -> CCATCTTAAAA
CCATCTTAAAA -> CATCTTAAAAT
CATCTTAAAAT -> ATCTTAAAATG
ATCTTAAAATG -> TCTTAAAATGC
TCTTAAAATGC -> CTTAAAATGCT
CTTAAAATGCT -> TTAAAATGCTA
TTAAAATGCTA -> TAAAATGCTAG
TAAAATGCTAG -> AAAATGCTAGA
AAAATGCTAGA -> AAATGCTAGAC
AAATGCTAGAC -> AATGCTAGACT
AATGCTAGACT -> ATGCTAGACTC
ATGCTAGACTC -> TGCTAGACTCC
TGCTAGACTCC -> GCTAGACTCCA
GCTAGACTCCA -> CTAGACTCCAC
CTAGACTCCAC -> TAGACTCCACC
TAGACTCCACC -> AGACTCCACCA
AGACTCCACCA -> GACTCCACCAA
GACTCCACCAA -> ACTCCACCAAG
ACTCCACCAAG -> CTCCACCAAGG
CTCCACCAAGG -> TCCACCAAGGG
TCCACCAAGGG -> CCACCAAGGGC
CCACCAAGGGC -> CACCAAGGGCA
CACCAAGGGCA -> ACCAAGGGCAC
ACCAAGGGCAC -> CCAAGGGCACC
CCAAGGGCACC -> CAAGGGCACCA
CAAGGGCACCA -> AAGGGCACCAG
AAGGGCACCAG -> AGGGCACCAGA
AGGGCACCAGA -> GGGCACCAGAA
GGGCACCAGAA -> GGCACCAGAAG
GGCACCAGAAG -> GCACCAGAAGT
GCACCAGAAGT -> CACCAGAAGTT
CACCAGAAGTT -> ACCAGAAGTTC
ACCAGAAGTTC -> CCAGAAGTTCG
CCAGAAGTTCG -> CAGAAGTTCGT
CAGAAGTTCGT -> AGAAGTTCGTA
AGAAGTTCGTA -> GAAGTTCGTAG
GAAGTTCGTAG -> AAGTTCGTAGA
AAGTTCGTAGA -> AGTTCGTAGAG
AGTTCGTAGAG -> GTTCGTAGAGC
GTTCGTAGAGC -> TTCGTAGAGCA
TTCGTAGAGCA -> TCGTAGAGCAT
TCGTAGAGCAT -> CGTAGAGCATA
CGTAGAGCATA -> GTAGAGCATAA
GTAGAGCATAA -> TAGAGCATAAA
TAGAGCATAAA -> AGAGCATAAAG
AGAGCATAAAG -> GAGCATAAAGC
GAGCATAAAGC -> AGCATAAAGCA
AGCATAAAGCA -> GCATAAAGCAC
GCATAAAGCAC -> CATAAAGCACA
CATAAAGCACA -> ATAAAGCACAC
ATAAAGCACAC -> TAAAGCACACA
TAAAGCACACA -> AAAGCACACAC
AAAGCACACAC -> AAGCACACACG
AAGCACACACG -> AGCACACACGA
AGCACACACGA -> GCACACACGAC
GCACACACGAC -> CACACACGACC
CACACACGACC -> ACACACGACCG
ACACACGACCG -> CACACGACCGC
CACACGACCGC -> ACACGACCGCA
ACACGACCGCA -> CACGACCGCAA
CACGACCGCAA -> ACGACCGCAAG
ACGACCGCAAG -> CGACCGCAAGT
CGACCGCAAGT -> GACCGCAAGTA
GACCGCAAGTA -> ACCGCAAGTAT
ACCGCAAGTAT -> CCGCAAGTATA
CCGCAAGTATA -> CGCAAGTATAG
CGCAAGTATAG -> GCAAGTATAGG
GCAAGTATAGG -> CAAGTATAGGA
CAAGTATAGGA -> AAGTATAGGAG
AAGTATAGGAG -> AGTATAGGAGA
AGTATAGGAGA -> GTATAGGAGAG
GTATAGGAGAG -> TATAGGAGAGT
TATAGGAGAGT -> ATAGGAGAGTC
ATAGGAGAGTC -> TAGGAGAGTCC
TAGGAGAGTCC -> AGGAGAGTCCG
AGGAGAGTCCG -> GGAGAGTCCGT
GGAGAGTCCGT -> GAGAGTCCGTC
GAGAGTCCGTC -> AGAGTCCGTCA
AGAGTCCGTCA -> GAGTCCGTCAA
GAGTCCGTCAA -> AGTCCGTCAAG
AGTCCGTCAAG -> GTCCGTCAAGC
GTCCGTCAAGC -> TCCGTCAAGCA
TCCGTCAAGCA -> CCGTCAAGCAT
CCGTCAAGCAT -> CGTCAAGCATT
CGTCAAGCATT -> GTCAAGCATTA
GTCAAGCATTA -> TCAAGCATTAT
TCAAGCATTAT -> CAAGCATTATG
CAAGCATTATG -> AAGCATTATGC
AAGCATTATGC -> AGCATTATGCC
AGCATTATGCC -> GCATTATGCCG
GCATTATGCCG -> CATTATGCCGG
CATTATGCCGG -> ATTATGCCGGT
ATTATGCCGGT -> TTATGCCGGTT
TTATGCCGGTT -> TATGCCGGTTA
TATGCCGGTTA -> ATGCCGGTTAT
ATGCCGGTTAT -> TGCCGGTTATA
TGCCGGTTATA -> GCCGGTTATAC
GCCGGTTATAC -> CCGGTTATACG
CCGGTTATACG -> CGGTTATACGT
CGGTTATACGT -> GGTTATACGTG
GGTTATACGTG -> GTTATACGTGC
GTTATACGTGC -> TTATACGTGCA
TTATACGTGCA -> TATACGTGCAC
TATACGTGCAC -> ATACGTGCACC
ATACGTGCACC -> TACGTGCACCA
TACGTGCACCA -> ACGTGCACCAG
ACGTGCACCAG -> CGTGCACCAGC
CGTGCACCAGC -> GTGCACCAGCG
GTGCACCAGCG -> TGCACCAGCGC
TGCACCAGCGC -> GCACCAGCGCT
GCACCAGCGCT -> CACCAGCGCTA
CACCAGCGCTA -> ACCAGCGCTAG
ACCAGCGCTAG -> CCAGCGCTAGG
CCAGCGCTAGG -> CAGCGCTAGGA
CAGCGCTAGGA -> AGCGCTAGGAA
AGCGCTAGGAA -> GCGCTAGGAAG
GCGCTAGGAAG -> CGCTAGGAAGT
CGCTAGGAAGT -> GCTAGGAAGTA
GCTAGGAAGTA -> CTAGGAAGTAC
CTAGGAAGTAC -> TAGGAAGTACC
TAGGAAGTACC -> AGGAAGTACCC
AGGAAGTACCC -> GGAAGTACCCG
GGAAGTACCCG -> GAAGTACCCGC
GAAGTACCCGC -> AAGTACCCGCT
AAGTACCCGCT -> AGTACCCGCTG
AGTACCCGCTG -> GTACCCGCTGG
GTACCCGCTGG -> TACCCGCTGGT
TACCCGCTGGT -> ACCCGCTGGTG
ACCCGCTGGTG -> CCCGCTGGTGA
CCCGCTGGTGA -> CCGCTGGTGAA
CCGCTGGTGAA -> CGCTGGTGAAC
CGCTGGTGAAC -> GCTGGTGAACA
GCTGGTGAACA -> CTGGTGAACAA
CTGGTGAACAA -> TGGTGAACAAT
TGGTGAACAAT -> GGTGAACAATC
GGTGAACAATC -> GTGAACAATCA
GTGAACAATCA -> TGAACAATCAA
TGAACAATCAA -> GAACAATCAAA
GAACAATCAAA -> AACAATCAAAA
AACAATCAAAA -> ACAATCAAAAT
ACAATCAAAAT -> CAATCAAAATG
CAATCAAAATG -> AATCAAAATGT
AATCAAAATGT -> ATCAAAATGTA
ATCAAAATGTA -> TCAAAATGTAT
TCAAAATGTAT -> CAAAATGTATC
CAAAATGTATC -> AAAATGTATCT
AAAATGTATCT -> AAATGTATCTT
AAATGTATCTT -> AATGTATCTTT
AATGTATCTTT -> ATGTATCTTTG
ATGTATCTTTG -> TGTATCTTTGC
TGTATCTTTGC -> GTATCTTTGCG
GTATCTTTGCG -> TATCTTTGCGT
TATCTTTGCGT -> ATCTTTGCGTC
ATCTTTGCGTC -> TCTTTGCGTCC
TCTTTGCGTCC -> CTTTGCGTCCT
CTTTGCGTCCT -> TTTGCGTCCTC
TTTGCGTCCTC -> TTGCGTCCTCC
TTGCGTCCTCC -> TGCGTCCTCCG
TGCGTCCTCCG -> GCGTCCTCCGG
GCGTCCTCCGG -> CGTCCTCCGGC
CGTCCTCCGGC -> GTCCTCCGGCG
GTCCTCCGGCG -> TCCTCCGGCGT
TCCTCCGGCGT -> CCTCCGGCGTG
CCTCCGGCGTG -> CTCCGGCGTGC
CTCCGGCGTGC -> TCCGGCGTGCT
TCCGGCGTGCT -> CCGGCGTGCTT
CCGGCGTGCTT -> CGGCGTGCTTA
CGGCGTGCTTA -> GGCGTGCTTAT
GGCGTGCTTAT -> GCGTGCTTATG
GCGTGCTTATG -> CGTGCTTATGC
CGTGCTTATGC -> GTGCTTATGCT
GTGCTTATGCT -> TGCTTATGCTC
TGCTTATGCTC -> GCTTATGCTCA
GCTTATGCTCA -> CTTATGCTCAC
CTTATGCTCAC -> TTATGCTCACC
TTATGCTCACC -> TATGCTCACCT
TATGCTCACCT -> ATGCTCACCTT
ATGCTCACCTT -> TGCTCACCTTC
TGCTCACCTTC -> GCTCACCTTCT
GCTCACCTTCT -> CTCACCTTCTA
CTCACCTTCTA -> TCACCTTCTAT
TCACCTTCTAT -> CACCTTCTATC
CACCTTCTATC -> ACCTTCTATCT
ACCTTCTATCT -> CCTTCTATCTC
CCTTCTATCTC -> CTTCTATCTCG
CTTCTATCTCG -> TTCTATCTCGT
TTCTATCTCGT -> TCTATCTCGTC
TCTATCTCGTC -> CTATCTCGTCT
CTATCTCGTCT -> TATCTCGTCTG
TATCTCGTCTG -> ATCTCGTCTGT
ATCTCGTCTGT -> TCTCGTCTGTA
TCTCGTCTGTA -> CTCGTCTGTAG
CTCGTCTGTAG -> TCGTCTGTAGT
TCGTCTGTAGT -> CGTCTGTAGTG
CGTCTGTAGTG -> GTCTGTAGTGT
GTCTGTAGTGT -> TCTGTAGTGTG
TCTGTAGTGTG -> CTGTAGTGTGA
CTGTAGTGTGA -> TGTAGTGTGAA
TGTAGTGTGAA -> GTAGTGTGAAT
GTAGTGTGAAT -> TAGTGTGAATC
TAGTGTGAATC -> AGTGTGAATCA
AGTGTGAATCA -> GTGTGAATCAG
GTGTGAATCAG -> TGTGAATCAGG
TGTGAATCAGG -> GTGAATCAGGA
GTGAATCAGGA -> TGAATCAGGAG
TGAATCAGGAG -> GAATCAGGAGT
GAATCAGGAGT -> AATCAGGAGTC
AATCAGGAGTC -> ATCAGGAGTCT
ATCAGGAGTCT -> TCAGGAGTCTA
TCAGGAGTCTA -> CAGGAGTCTAC
CAGGAGTCTAC -> AGGAGTCTACC
AGGAGTCTACC -> GGAGTCTACCT
GGAGTCTACCT -> GAGTCTACCTT
GAGTCTACCTT -> AGTCTACCTTT
AGTCTACCTTT -> GTCTACCTTTG
GTCTACCTTTG -> TCTACCTTTGG
TCTACCTTTGG -> CTACCTTTGGA
CTACCTTTGGA -> TACCTTTGGAT
TACCTTTGGAT -> ACCTTTGGATA
ACCTTTGGATA -> CCTTTGGATAC
CCTTTGGATAC -> CTTTGGATACC
CTTTGGATACC -> TTTGGATACCC
TTTGGATACCC -> TTGGATACCCG
TTGGATACCCG -> TGGATACCCGG
TGGATACCCGG -> GGATACCCGGC
GGATACCCGGC -> GATACCCGGCC
GATACCCGGCC -> ATACCCGGCCC
ATACCCGGCCC -> TACCCGGCCCG
TACCCGGCCCG -> ACCCGGCCCGT
ACCCGGCCCGT -> CCCGGCCCGTA
CCCGGCCCGTA -> CCGGCCCGTAA
CCGGCCCGTAA -> CGGCCCGTAAT
CGGCCCGTAAT -> GGCCCGTAATG
GGCCCGTAATG -> GCCCGTAATGT
GCCCGTAATGT -> CCCGTAATGTG
CCCGTAATGTG -> CCGTAATGTGA
CCGTAATGTGA -> CGTAATGTGAA
CGTAATGTGAA -> GTAATGTGAAA
GTAATGTGAAA -> TAATGTGAAAT
TAATGTGAAAT -> AATGTGAAATT
AATGTGAAATT -> ATGTGAAATTC
ATGTGAAATTC -> TGTGAAATTCA
TGTGAAATTCA -> GTGAAATTCAA
GTGAAATTCAA -> TGAAATTCAAA
TGAAATTCAAA -> GAAATTCAAAA
GAAATTCAAAA -> AAATTCAAAAA
AAATTCAAAAA -> AATTCAAAAAT
AATTCAAAAAT -> ATTCAAAAATT
ATTCAAAAATT -> TTCAAAAATTT
TTCAAAAATTT -> TCAAAAATTTA
TCAAAAATTTA -> CAAAAATTTAG
CAAAAATTTAG -> AAAAATTTAGC
AAAAATTTAGC -> AAAATTTAGCT
AAAATTTAGCT -> AAATTTAGCTA
AAATTTAGCTA -> AATTTAGCTAT
AATTTAGCTAT -> ATTTAGCTATA
ATTTAGCTATA -> TTTAGCTATAT
TTTAGCTATAT -> TTAGCTATATG
TTAGCTATATG -> TAGCTATATGG
TAGCTATATGG -> AGCTATATGGT
AGCTATATGGT -> GCTATATGGTA
GCTATATGGTA -> CTATATGGTAA
CTATATGGTAA -> TATATGGTAAG
TATATGGTAAG -> ATATGGTAAGT
ATATGGTAAGT -> TATGGTAAGTG
TATGGTAAGTG -> ATGGTAAGTGC
ATGGTAAGTGC -> TGGTAAGTGCC
TGGTAAGTGCC -> GGTAAGTGCCG
GGTAAGTGCCG -> GTAAGTGCCGG
GTAAGTGCCGG -> TAAGTGCCGGG
TAAGTGCCGGG -> AAGTGCCGGGA
AAGTGCCGGGA -> AGTGCCGGGAG
AGTGCCGGGAG -> GTGCCGGGAGC
GTGCCGGGAGC -> TGCCGGGAGCG
TGCCGGGAGCG -> GCCGGGAGCGA
GCCGGGAGCGA -> CCGGGAGCGAC
CCGGGAGCGAC -> CGGGAGCGACG
CGGGAGCGACG -> GGGAGCGACGC
GGGAGCGACGC -> GGAGCGACGCT
GGAGCGACGCT -> GAGCGACGCTG
GAGCGACGCTG -> AGCGACGCTGC
AGCGACGCTGC -> GCGACGCTGCC
GCGACGCTGCC -> CGACGCTGCCT
CGACGCTGCCT -> GACGCTGCCTA
GACGCTGCCTA -> ACGCTGCCTAG
ACGCTGCCTAG -> CGCTGCCTAGG
CGCTGCCTAGG -> GCTGCCTAGGG
GCTGCCTAGGG -> CTGCCTAGGGT
CTGCCTAGGGT -> TGCCTAGGGTT
TGCCTAGGGTT -> GCCTAGGGTTA
GCCTAGGGTTA -> CCTAGGGTTAA
CCTAGGGTTAA -> CTAGGGTTAAC
CTAGGGTTAAC -> TAGGGTTAACT
TAGGGTTAACT -> AGGGTTAACTA
AGGGTTAACTA -> GGGTTAACTAC
GGGTTAACTAC -> GGTTAACTACG
GGTTAACTACG -> GTTAACTACGC
GTTAACTACGC -> TTAACTACGCT
TTAACTACGCT -> TAACTACGCTG
TAACTACGCTG -> AACTACGCTGG
AACTACGCTGG -> ACTACGCTGGT
ACTACGCTGGT -> CTACGCTGGTA
CTACGCTGGTA -> TACGCTGGTAC
TACGCTGGTAC -> ACGCTGGTACA
ACGCTGGTACA -> CGCTGGTACAG
CGCTGGTACAG -> GCTGGTACAGG
GCTGGTACAGG -> CTGGTACAGGA
CTGGTACAGGA -> TGGTACAGGAG
TGGTACAGGAG -> GGTACAGGAGT
GGTACAGGAGT -> GTACAGGAGTT
GTACAGGAGTT -> TACAGGAGTTG
TACAGGAGTTG -> ACAGGAGTTGT
ACAGGAGTTGT -> CAGGAGTTGTT
CAGGAGTTGTT -> AGGAGTTGTTA
AGGAGTTGTTA -> GGAGTTGTTAA
GGAGTTGTTAA -> GAGTTGTTAAC
GAGTTGTTAAC -> AGTTGTTAACG
AGTTGTTAACG -> GTTGTTAACGA
GTTGTTAACGA -> TTGTTAACGAT
TTGTTAACGAT -> TGTTAACGATC
TGTTAACGATC -> GTTAACGATCA
GTTAACGATCA -> TTAACGATCAT
TTAACGATCAT -> TAACGATCATT
TAACGATCATT -> AACGATCATTG
AACGATCATTG -> ACGATCATTGT
ACGATCATTGT -> CGATCATTGTA
CGATCATTGTA -> GATCATTGTAA
GATCATTGTAA -> ATCATTGTAAT
ATCATTGTAAT -> TCATTGTAATG
TCATTGTAATG -> CATTGTAATGA
CATTGTAATGA -> ATTGTAATGAT
ATTGTAATGAT -> TTGTAATGATA
TTGTAATGATA -> TGTAATGATAT
TGTAATGATAT -> GTAATGATATT
GTAATGATATT -> TAATGATATTT
TAATGATATTT -> AATGATATTTT
AATGATATTTT -> ATGATATTTTA
ATGATATTTTA -> TGATATTTTAC
TGATATTTTAC -> GATATTTTACC
GATATTTTACC -> ATATTTTACCA
ATATTTTACCA -> TATTTTACCAG
TATTTTACCAG -> ATTTTACCAGG
ATTTTACCAGG -> TTTTACCAGGC
TTTTACCAGGC -> TTTACCAGGCA
TTTACCAGGCA -> TTACCAGGCAA
TTACCAGGCAA -> TACCAGGCAAT
TACCAGGCAAT -> ACCAGGCAATG
ACCAGGCAATG -> CCAGGCAATGT
CCAGGCAATGT -> CAGGCAATGTG
CAGGCAATGTG -> AGGCAATGTGT
AGGCAATGTGT -> GGCAATGTGTC
GGCAATGTGTC -> GCAATGTGTCG
GCAATGTGTCG -> CAATGTGTCGC
CAATGTGTCGC -> AATGTGTCGCG
AATGTGTCGCG -> ATGTGTCGCGA
ATGTGTCGCGA -> TGTGTCGCGAA
TGTGTCGCGAA -> GTGTCGCGAAA
GTGTCGCGAAA -> TGTCGCGAAAA
TGTCGCGAAAA -> GTCGCGAAAAA
GTCGCGAAAAA -> TCGCGAAAAAT
TCGCGAAAAAT -> CGCGAAAAATC
CGCGAAAAATC -> GCGAAAAATCA
GCGAAAAATCA -> CGAAAAATCAC
CGAAAAATCAC -> GAAAAATCACT
GAAAAATCACT -> AAAAATCACTT
AAAAATCACTT -> AAAATCACTTC
AAAATCACTTC -> AAATCACTTCC
AAATCACTTCC -> AATCACTTCCT
AATCACTTCCT -> ATCACTTCCTC
ATCACTTCCTC -> TCACTTCCTCG
TCACTTCCTCG -> CACTTCCTCGT
CACTTCCTCGT -> ACTTCCTCGTA
ACTTCCTCGTA -> CTTCCTCGTAC
CTTCCTCGTAC -> TTCCTCGTACT
TTCCTCGTACT -> TCCTCGTACTG
TCCTCGTACTG -> CCTCGTACTGA
CCTCGTACTGA -> CTCGTACTGAA
CTCGTACTGAA -> TCGTACTGAAG
TCGTACTGAAG -> CGTACTGAAGT
CGTACTGAAGT -> GTACTGAAGTC
GTACTGAAGTC -> TACTGAAGTCA
TACTGAAGTCA -> ACTGAAGTCAG
ACTGAAGTCAG -> CTGAAGTCAGG
CTGAAGTCAGG -> TGAAGTCAGGA
TGAAGTCAGGA -> GAAGTCAGGAT
GAAGTCAGGAT -> AAGTCAGGATG
AAGTCAGGATG -> AGTCAGGATGG
AGTCAGGATGG -> GTCAGGATGGT
GTCAGGATGGT -> TCAGGATGGTG
TCAGGATGGTG -> CAGGATGGTGG
CAGGATGGTGG -> AGGATGGTGGC
AGGATGGTGGC -> GGATGGTGGCT
GGATGGTGGCT -> GATGGTGGCTT
GATGGTGGCTT -> ATGGTGGCTTC
ATGGTGGCTTC -> TGGTGGCTTCT
TGGTGGCTTCT -> GGTGGCTTCTT
GGTGGCTTCTT -> GTGGCTTCTTA
GTGGCTTCTTA -> TGGCTTCTTAA
TGGCTTCTTAA -> GGCTTCTTAAT
GGCTTCTTAAT -> GCTTCTTAATC
GCTTCTTAATC -> CTTCTTAATCA
CTTCTTAATCA -> TTCTTAATCAT
TTCTTAATCAT -> TCTTAATCATG
TCTTAATCATG -> CTTAATCATGG
CTTAATCATGG -> TTAATCATGGC
TTAATCATGGC -> TAATCATGGCT
TAATCATGGCT -> AATCATGGCTC
AATCATGGCTC -> ATCATGGCTCA
ATCATGGCTCA -> TCATGGCTCAT
TCATGGCTCAT -> CATGGCTCATA
CATGGCTCATA -> ATGGCTCATAC
ATGGCTCATAC -> TGGCTCATACG
TGGCTCATACG -> GGCTCATACGA
GGCTCATACGA -> GCTCATACGAA
GCTCATACGAA -> CTCATACGAAG
CTCATACGAAG -> TCATACGAAGT
TCATACGAAGT -> CATACGAAGTA
CATACGAAGTA -> ATACGAAGTAC
ATACGAAGTAC -> TACGAAGTACA
TACGAAGTACA -> ACGAAGTACAA
ACGAAGTACAA -> CGAAGTACAAA
CGAAGTACAAA -> GAAGTACAAAT
GAAGTACAAAT -> AAGTACAAATC
AAGTACAAATC -> AGTACAAATCT
AGTACAAATCT -> GTACAAATCTC
GTACAAATCTC -> TACAAATCTCA
TACAAATCTCA -> ACAAATCTCAC
ACAAATCTCAC -> CAAATCTCACA
CAAATCTCACA -> AAATCTCACAA
AAATCTCACAA -> AATCTCACAAG
AATCTCACAAG -> ATCTCACAAGG
ATCTCACAAGG -> TCTCACAAGGT
TCTCACAAGGT -> CTCACAAGGTG
CTCACAAGGTG -> TCACAAGGTGG
TCACAAGGTGG -> CACAAGGTGGT
CACAAGGTGGT -> ACAAGGTGGTA
ACAAGGTGGTA -> CAAGGTGGTAT
CAAGGTGGTAT -> AAGGTGGTATA
AAGGTGGTATA -> AGGTGGTATAT
AGGTGGTATAT -> GGTGGTATATT
GGTGGTATATT -> GTGGTATATTA
GTGGTATATTA -> TGGTATATTAA
TGGTATATTAA -> GGTATATTAAC
GGTATATTAAC -> GTATATTAACG
GTATATTAACG -> TATATTAACGT
TATATTAACGT -> ATATTAACGTA
ATATTAACGTA -> TATTAACGTAC
TATTAACGTAC -> ATTAACGTACG
ATTAACGTACG -> TTAACGTACGC
TTAACGTACGC -> TAACGTACGCA
TAACGTACGCA -> AACGTACGCAC
AACGTACGCAC -> ACGTACGCACC
ACGTACGCACC -> CGTACGCACCA
CGTACGCACCA -> GTACGCACCAC
GTACGCACCAC -> TACGCACCACA
TACGCACCACA -> ACGCACCACAC
ACGCACCACAC -> CGCACCACACG
CGCACCACACG -> GCACCACACGT
GCACCACACGT -> CACCACACGTG
CACCACACGTG -> ACCACACGTGC
ACCACACGTGC -> CCACACGTGCG
CCACACGTGCG -> CACACGTGCGC
CACACGTGCGC -> ACACGTGCGCC
ACACGTGCGCC -> CACGTGCGCCT
CACGTGCGCCT -> ACGTGCGCCTA
ACGTGCGCCTA -> CGTGCGCCTAT
CGTGCGCCTAT -> GTGCGCCTATA
GTGCGCCTATA -> TGCGCCTATAT
TGCGCCTATAT -> GCGCCTATATT
GCGCCTATATT -> CGCCTATATTC
CGCCTATATTC -> GCCTATATTCT
GCCTATATTCT -> CCTATATTCTT
CCTATATTCTT -> CTATATTCTTG
CTATATTCTTG -> TATATTCTTGC
TATATTCTTGC -> ATATTCTTGCC
ATATTCTTGCC -> TATTCTTGCCA
TATTCTTGCCA -> ATTCTTGCCAG
ATTCTTGCCAG -> TTCTTGCCAGT
TTCTTGCCAGT -> TCTTGCCAGTC
TCTTGCCAGTC -> CTTGCCAGTCG
CTTGCCAGTCG -> TTGCCAGTCGC
TTGCCAGTCGC -> TGCCAGTCGCT
TGCCAGTCGCT -> GCCAGTCGCTG
GCCAGTCGCTG -> CCAGTCGCTGT
CCAGTCGCTGT -> CAGTCGCTGTC
CAGTCGCTGTC -> AGTCGCTGTCG
AGTCGCTGTCG -> GTCGCTGTCGT
GTCGCTGTCGT -> TCGCTGTCGTT
TCGCTGTCGTT -> CGCTGTCGTTG
CGCTGTCGTTG -> GCTGTCGTTGC
GCTGTCGTTGC -> CTGTCGTTGCC
CTGTCGTTGCC -> TGTCGTTGCCG
TGTCGTTGCCG -> GTCGTTGCCGT
GTCGTTGCCGT -> TCGTTGCCGTA
TCGTTGCCGTA -> CGTTGCCGTAA
CGTTGCCGTAA -> GTTGCCGTAAA
GTTGCCGTAAA -> TTGCCGTAAAT
TTGCCGTAAAT -> TGCCGTAAATC
TGCCGTAAATC -> GCCGTAAATCC
GCCGTAAATCC -> CCGTAAATCCG
CCGTAAATCCG -> CGTAAATCCGA
CGTAAATCCGA -> GTAAATCCGAC
GTAAATCCGAC -> TAAATCCGACC
TAAATCCGACC -> AAATCCGACCT
AAATCCGACCT -> AATCCGACCTG
AATCCGACCTG -> ATCCGACCTGG
ATCCGACCTGG -> TCCGACCTGGG
TCCGACCTGGG -> CCGACCTGGGC
CCGACCTGGGC -> CGACCTGGGCG
CGACCTGGGCG -> GACCTGGGCGT
GACCTGGGCGT -> ACCTGGGCGTT
ACCTGGGCGTT -> CCTGGGCGTTG
CCTGGGCGTTG -> CTGGGCGTTGG
CTGGGCGTTGG -> TGGGCGTTGGG
TGGGCGTTGGG -> GGGCGTTGGGA
GGGCGTTGGGA -> GGCGTTGGGAA
GGCGTTGGGAA -> GCGTTGGGAAG
GCGTTGGGAAG -> CGTTGGGAAGT
CGTTGGGAAGT -> GTTGGGAAGTA
GTTGGGAAGTA -> TTGGGAAGTAG
TTGGGAAGTAG -> TGGGAAGTAGA
TGGGAAGTAGA -> GGGAAGTAGAC
GGGAAGTAGAC -> GGAAGTAGACA
GGAAGTAGACA -> GAAGTAGACAA
GAAGTAGACAA -> AAGTAGACAAC
AAGTAGACAAC -> AGTAGACAACA
AGTAGACAACA -> GTAGACAACAG
GTAGACAACAG -> TAGACAACAGA
TAGACAACAGA -> AGACAACAGAT
AGACAACAGAT -> GACAACAGATT
GACAACAGATT -> ACAACAGATTC
ACAACAGATTC -> CAACAGATTCA
CAACAGATTCA -> AACAGATTCAA
AACAGATTCAA -> ACAGATTCAAC
ACAGATTCAAC -> CAGATTCAACT
CAGATTCAACT -> AGATTCAACTA
AGATTCAACTA -> GATTCAACTAG
GATTCAACTAG -> ATTCAACTAGA
ATTCAACTAGA -> TTCAACTAGAG
TTCAACTAGAG -> TCAACTAGAGT
TCAACTAGAGT -> CAACTAGAGTC
CAACTAGAGTC -> AACTAGAGTCT
AACTAGAGTCT -> ACTAGAGTCTT
ACTAGAGTCTT -> CTAGAGTCTTT
CTAGAGTCTTT -> TAGAGTCTTTT
TAGAGTCTTTT -> AGAGTCTTTTG
AGAGTCTTTTG -> GAGTCTTTTGA
GAGTCTTTTGA -> AGTCTTTTGAT
AGTCTTTTGAT -> GTCTTTTGATT
GTCTTTTGATT -> TCTTTTGATTC
TCTTTTGATTC -> CTTTTGATTCC
CTTTTGATTCC -> TTTTGATTCCT
TTTTGATTCCT -> TTTGATTCCTA
TTTGATTCCTA -> TTGATTCCTAT
TTGATTCCTAT -> TGATTCCTATA
TGATTCCTATA -> GATTCCTATAT
GATTCCTATAT -> ATTCCTATATT
ATTCCTATATT -> TTCCTATATTT
TTCCTATATTT -> TCCTATATTTA
TCCTATATTTA -> CCTATATTTAT
CCTATATTTAT -> CTATATTTATG
CTATATTTATG -> TATATTTATGC
TATATTTATGC -> ATATTTATGCG
ATATTTATGCG -> TATTTATGCGT
TATTTATGCGT -> ATTTATGCGTA
ATTTATGCGTA -> TTTATGCGTAA
TTTATGCGTAA -> TTATGCGTAAG
TTATGCGTAAG -> TATGCGTAAGG
TATGCGTAAGG -> ATGCGTAAGGA
ATGCGTAAGGA -> TGCGTAAGGAG
TGCGTAAGGAG -> GCGTAAGGAGT
GCGTAAGGAGT -> CGTAAGGAGTT
CGTAAGGAGTT -> GTAAGGAGTTA
GTAAGGAGTTA -> TAAGGAGTTAC
TAAGGAGTTAC -> AAGGAGTTACG
AAGGAGTTACG -> AGGAGTTACGA
AGGAGTTACGA -> GGAGTTACGAT
GGAGTTACGAT -> GAGTTACGATG
GAGTTACGATG -> AGTTACGATGA
AGTTACGATGA -> GTTACGATGAA
GTTACGATGAA -> TTACGATGAAC
TTACGATGAAC -> TACGATGAACG
TACGATGAACG -> ACGATGAACGA
ACGATGAACGA -> CGATGAACGAT
CGATGAACGAT -> GATGAACGATT
GATGAACGATT -> ATGAACGATTC
ATGAACGATTC -> TGAACGATTCG
TGAACGATTCG -> GAACGATTCGC
GAACGATTCGC -> AACGATTCGCC
AACGATTCGCC -> ACGATTCGCCT
ACGATTCGCCT -> CGATTCGCCTA
CGATTCGCCTA -> GATTCGCCTAG
GATTCGCCTAG -> ATTCGCCTAGA
ATTCGCCTAGA -> TTCGCCTAGAA
TTCGCCTAGAA -> TCGCCTAGAAC
TCGCCTAGAAC -> CGCCTAGAACT
CGCCTAGAACT -> GCCTAGAACTG
GCCTAGAACTG -> CCTAGAACTGC
CCTAGAACTGC -> CTAGAACTGCT
CTAGAACTGCT -> TAGAACTGCTG
TAGAACTGCTG -> AGAACTGCTGT
AGAACTGCTGT -> GAACTGCTGTT,GAACTGCTGTC
GAACTGCTGTT -> AACTGCTGTTT
AACTGCTGTTT -> ACTGCTGTTTC
ACTGCTGTTTC -> CTGCTGTTTCC
CTGCTGTTTCC -> TGCTGTTTCCG
TGCTGTTTCCG -> GCTGTTTCCGA
GCTGTTTCCGA -> CTGTTTCCGAA
CTGTTTCCGAA -> TGTTTCCGAAT
TGTTTCCGAAT -> GTTTCCGAATG
GTTTCCGAATG -> TTTCCGAATGG
TTTCCGAATGG -> TTCCGAATGGC
TTCCGAATGGC -> TCCGAATGGCG
TCCGAATGGCG -> CCGAATGGCGC
CCGAATGGCGC -> CGAATGGCGCA
CGAATGGCGCA -> GAATGGCGCAC
GAATGGCGCAC -> AATGGCGCACG
AATGGCGCACG -> ATGGCGCACGA
ATGGCGCACGA -> TGGCGCACGAC
TGGCGCACGAC -> GGCGCACGACT
GGCGCACGACT -> GCGCACGACTG
GCGCACGACTG -> CGCACGACTGT
CGCACGACTGT -> GCACGACTGTA
GCACGACTGTA -> CACGACTGTAT
CACGACTGTAT -> ACGACTGTATT
ACGACTGTATT -> CGACTGTATTT
CGACTGTATTT -> GACTGTATTTG
GACTGTATTTG -> ACTGTATTTGT
ACTGTATTTGT -> CTGTATTTGTT
CTGTATTTGTT -> TGTATTTGTTT
TGTATTTGTTT -> GTATTTGTTTA
GTATTTGTTTA -> TATTTGTTTAA
TATTTGTTTAA -> ATTTGTTTAAT
ATTTGTTTAAT -> TTTGTTTAATA
TTTGTTTAATA -> TTGTTTAATAC
TTGTTTAATAC -> TGTTTAATACA
TGTTTAATACA -> GTTTAATACAT
GTTTAATACAT -> TTTAATACATT
TTTAATACATT -> TTAATACATTC
TTAATACATTC -> TAATACATTCC
TAATACATTCC -> AATACATTCCT
AATACATTCCT -> ATACATTCCTA
ATACATTCCTA -> TACATTCCTAA
TACATTCCTAA -> ACATTCCTAAC
ACATTCCTAAC -> CATTCCTAACG
CATTCCTAACG -> ATTCCTAACGC
ATTCCTAACGC -> TTCCTAACGCA
TTCCTAACGCA -> TCCTAACGCAC
TCCTAACGCAC -> CCTAACGCACT
CCTAACGCACT -> CTAACGCACTG
CTAACGCACTG -> TAACGCACTGG
TAACGCACTGG -> AACGCACTGGT
AACGCACTGGT -> ACGCACTGGTC
ACGCACTGGTC -> CGCACTGGTCT
CGCACTGGTCT -> GCACTGGTCTT
GCACTGGTCTT -> CACTGGTCTTC
CACTGGTCTTC -> ACTGGTCTTCG
ACTGGTCTTCG -> CTGGTCTTCGG
CTGGTCTTCGG -> TGGTCTTCGGG
TGGTCTTCGGG -> GGTCTTCGGGT
GGTCTTCGGGT -> GTCTTCGGGTG
GTCTTCGGGTG -> TCTTCGGGTGA
TCTTCGGGTGA -> CTTCGGGTGAT
CTTCGGGTGAT -> TTCGGGTGATT
TTCGGGTGATT -> TCGGGTGATTC
TCGGGTGATTC -> CGGGTGATTCG
CGGGTGATTCG -> GGGTGATTCGT
GGGTGATTCGT -> GGTGATTCGTA
GGTGATTCGTA -> GTGATTCGTAT
GTGATTCGTAT -> TGATTCGTATT
TGATTCGTATT -> GATTCGTATTA
GATTCGTATTA -> ATTCGTATTAC
ATTCGTATTAC -> TTCGTATTACC
TTCGTATTACC -> TCGTATTACCA
TCGTATTACCA -> CGTATTACCAG
CGTATTACCAG -> GTATTACCAGC
GTATTACCAGC -> TATTACCAGCT
TATTACCAGCT -> ATTACCAGCTA
ATTACCAGCTA -> TTACCAGCTAG
TTACCAGCTAG -> TACCAGCTAGA
TACCAGCTAGA -> ACCAGCTAGAG
ACCAGCTAGAG -> CCAGCTAGAGA
CCAGCTAGAGA -> CAGCTAGAGAC
CAGCTAGAGAC -> AGCTAGAGACG
AGCTAGAGACG -> GCTAGAGACGA
GCTAGAGACGA -> CTAGAGACGAC
CTAGAGACGAC -> TAGAGACGACC
TAGAGACGACC -> AGAGACGACCT
AGAGACGACCT -> GAGACGACCTC
GAGACGACCTC -> AGACGACCTCC
AGACGACCTCC -> GACGACCTCCT
GACGACCTCCT -> ACGACCTCCTG
ACGACCTCCTG -> CGACCTCCTGC
CGACCTCCTGC -> GACCTCCTGCC
GACCTCCTGCC -> ACCTCCTGCCA
ACCTCCTGCCA -> CCTCCTGCCAG
CCTCCTGCCAG -> CTCCTGCCAGC
CTCCTGCCAGC -> TCCTGCCAGCC
TCCTGCCAGCC -> CCTGCCAGCCT
CCTGCCAGCCT -> CTGCCAGCCTA
CTGCCAGCCTA -> TGCCAGCCTAT
TGCCAGCCTAT -> GCCAGCCTATT
GCCAGCCTATT -> CCAGCCTATTC
CCAGCCTATTC -> CAGCCTATTCG
CAGCCTATTCG -> AGCCTATTCGA
AGCCTATTCGA -> GCCTATTCGAC
GCCTATTCGAC -> CCTATTCGACC
CCTATTCGACC -> CTATTCGACCG
CTATTCGACCG -> TATTCGACCGC
TATTCGACCGC -> ATTCGACCGCT
ATTCGACCGCT -> TTCGACCGCTT
TTCGACCGCTT -> TCGACCGCTTA
TCGACCGCTTA -> CGACCGCTTAC
CGACCGCTTAC -> GACCGCTTACC
GACCGCTTACC -> ACCGCTTACCA
ACCGCTTACCA -> CCGCTTACCAT
CCGCTTACCAT -> CGCTTACCATC
CGCTTACCATC -> GCTTACCATCT
GCTTACCATCT -> CTTACCATCTA
CTTACCATCTA -> TTACCATCTAG
TTACCATCTAG -> TACCATCTAGT
TACCATCTAGT -> ACCATCTAGTC
ACCATCTAGTC -> CCATCTAGTCT
CCATCTAGTCT -> CATCTAGTCTC
CATCTAGTCTC -> ATCTAGTCTCC
ATCTAGTCTCC -> TCTAGTCTCCA
TCTAGTCTCCA -> CTAGTCTCCAC
CTAGTCTCCAC -> TAGTCTCCACA
TAGTCTCCACA -> AGTCTCCACAA
AGTCTCCACAA -> GTCTCCACAAT
GTCTCCACAAT -> TCTCCACAATG
TCTCCACAATG -> CTCCACAATGT
CTCCACAATGT -> TCCACAATGTT
TCCACAATGTT -> CCACAATGTTG
CCACAATGTTG -> CACAATGTTGG
CACAATGTTGG -> ACAATGTTGGA
ACAATGTTGGA -> CAATGTTGGAG
CAATGTTGGAG -> AATGTTGGAGC
AATGTTGGAGC -> ATGTTGGAGCT
ATGTTGGAGCT -> TGTTGGAGCTA
TGTTGGAGCTA -> GTTGGAGCTAG
GTTGGAGCTAG -> TTGGAGCTAGA
TTGGAGCTAGA -> TGGAGCTAGAA
TGGAGCTAGAA -> GGAGCTAGAAT
GGAGCTAGAAT -> GAGCTAGAATA
GAGCTAGAATA -> AGCTAGAATAA
AGCTAGAATAA -> GCTAGAATAAT
GCTAGAATAAT -> CTAGAATAATA
CTAGAATAATA -> TAGAATAATAT
TAGAATAATAT -> AGAATAATATG
AGAATAATATG -> GAATAATATGC
GAATAATATGC -> AATAATATGCG
AATAATATGCG -> ATAATATGCGG
ATAATATGCGG -> TAATATGCGGA
TAATATGCGGA -> AATATGCGGAT
AATATGCGGAT -> ATATGCGGATG
ATATGCGGATG -> TATGCGGATGA
TATGCGGATGA -> ATGCGGATGAG
ATGCGGATGAG -> TGCGGATGAGA
TGCGGATGAGA -> GCGGATGAGAA
GCGGATGAGAA -> CGGATGAGAAG
CGGATGAGAAG -> GGATGAGAAGC
GGATGAGAAGC -> GATGAGAAGCG
GATGAGAAGCG -> ATGAGAAGCGA
ATGAGAAGCGA -> TGAGAAGCGAA
TGAGAAGCGAA -> GAGAAGCGAAG
GAGAAGCGAAG -> AGAAGCGAAGA
AGAAGCGAAGA -> GAAGCGAAGAC
GAAGCGAAGAC -> AAGCGAAGACG
AAGCGAAGACG -> AGCGAAGACGG
AGCGAAGACGG -> GCGAAGACGGT
GCGAAGACGGT -> CGAAGACGGTC
CGAAGACGGTC -> GAAGACGGTCG
GAAGACGGTCG -> AAGACGGTCGA
AAGACGGTCGA -> AGACGGTCGAA
AGACGGTCGAA -> GACGGTCGAAT
GACGGTCGAAT -> ACGGTCGAATG
ACGGTCGAATG -> CGGTCGAATGC
CGGTCGAATGC -> GGTCGAATGCC
GGTCGAATGCC -> GTCGAATGCCT
GTCGAATGCCT -> TCGAATGCCTA
TCGAATGCCTA -> CGAATGCCTAC
CGAATGCCTAC -> GAATGCCTACA
GAATGCCTACA -> AATGCCTACAA
AATGCCTACAA -> ATGCCTACAAC
ATGCCTACAAC -> TGCCTACAACG
TGCCTACAACG -> GCCTACAACGC
GCCTACAACGC -> CCTACAACGCA
CCTACAACGCA -> CTACAACGCAA
CTACAACGCAA -> TACAACGCAAG
TACAACGCAAG -> ACAACGCAAGA
ACAACGCAAGA -> CAACGCAAGAA
CAACGCAAGAA -> AACGCAAGAAC
AACGCAAGAAC -> ACGCAAGAACT
ACGCAAGAACT -> CGCAAGAACTG
CGCAAGAACTG -> GCAAGAACTGC
GCAAGAACTGC -> CAAGAACTGCT
CAAGAACTGCT -> AAGAACTGCTG
AAGAACTGCTG -> AGAACTGCTGT
GAACTGCTGTC -> AACTGCTGTCC
AACTGCTGTCC -> ACTGCTGTCCG
ACTGCTGTCCG -> CTGCTGTCCGA
CTGCTGTCCGA -> TGCTGTCCGAT
TGCTGTCCGAT -> GCTGTCCGATT
GCTGTCCGATT -> CTGTCCGATTA
CTGTCCGATTA -> TGTCCGATTAT
TGTCCGATTAT -> GTCCGATTATC
GTCCGATTATC -> TCCGATTATCC
TCCGATTATCC -> CCGATTATCCA
CCGATTATCCA -> CGATTATCCAA
CGATTATCCAA -> GATTATCCAAG
GATTATCCAAG -> ATTATCCAAGC
ATTATCCAAGC -> TTATCCAAGCA
TTATCCAAGCA -> TATCCAAGCAG
TATCCAAGCAG -> ATCCAAGCAGG
ATCCAAGCAGG -> TCCAAGCAGGA
TCCAAGCAGGA -> CCAAGCAGGAA
CCAAGCAGGAA -> CAAGCAGGAAG
CAAGCAGGAAG -> AAGCAGGAAGG
AAGCAGGAAGG -> AGCAGGAAGGT
AGCAGGAAGGT -> GCAGGAAGGTC
GCAGGAAGGTC -> CAGGAAGGTCT
CAGGAAGGTCT -> AGGAAGGTCTC
AGGAAGGTCTC -> GGAAGGTCTCC
GGAAGGTCTCC -> GAAGGTCTCCT
GAAGGTCTCCT -> AAGGTCTCCTG
AAGGTCTCCTG -> AGGTCTCCTGC
AGGTCTCCTGC -> GGTCTCCTGCT
GGTCTCCTGCT -> GTCTCCTGCTC
GTCTCCTGCTC -> TCTCCTGCTCG
TCTCCTGCTCG -> CTCCTGCTCGT
CTCCTGCTCGT -> TCCTGCTCGTT
TCCTGCTCGTT -> CCTGCTCGTTC
CCTGCTCGTTC -> CTGCTCGTTCT
CTGCTCGTTCT -> TGCTCGTTCTG
TGCTCGTTCTG -> GCTCGTTCTGT
GCTCGTTCTGT -> CTCGTTCTGTA
CTCGTTCTGTA -> TCGTTCTGTAC
TCGTTCTGTAC -> CGTTCTGTACT
CGTTCTGTACT -> GTTCTGTACTC
GTTCTGTACTC -> TTCTGTACTCG
TTCTGTACTCG -> TCTGTACTCGG
TCTGTACTCGG -> CTGTACTCGGG
CTGTACTCGGG -> TGTACTCGGGT
TGTACTCGGGT -> GTACTCGGGTT
GTACTCGGGTT -> TACTCGGGTTC
TACTCGGGTTC -> ACTCGGGTTCG
ACTCGGGTTCG -> CTCGGGTTCGC
CTCGGGTTCGC -> TCGGGTTCGCG
TCGGGTTCGCG -> CGGGTTCGCGG
CGGGTTCGCGG -> GGGTTCGCGGC
GGGTTCGCGGC -> GGTTCGCGGCG
GGTTCGCGGCG -> GTTCGCGGCGG
GTTCGCGGCGG -> TTCGCGGCGGA
TTCGCGGCGGA -> TCGCGGCGGAG
TCGCGGCGGAG -> CGCGGCGGAGG
CGCGGCGGAGG -> GCGGCGGAGGC
GCGGCGGAGGC -> CGGCGGAGGCT
CGGCGGAGGCT -> GGCGGAGGCTG
GGCGGAGGCTG -> GCGGAGGCTGA
GCGGAGGCTGA -> CGGAGGCTGAT
CGGAGGCTGAT -> GGAGGCTGATT
GGAGGCTGATT -> GAGGCTGATTC
GAGGCTGATTC -> AGGCTGATTCC
AGGCTGATTCC -> GGCTGATTCCA
GGCTGATTCCA -> GCTGATTCCAC
GCTGATTCCAC -> CTGATTCCACA
CTGATTCCACA -> TGATTCCACAG
TGATTCCACAG -> GATTCCACAGG
GATTCCACAGG -> ATTCCACAGGT
ATTCCACAGGT -> TTCCACAGGTC
TTCCACAGGTC -> TCCACAGGTCT
TCCACAGGTCT -> CCACAGGTCTA
CCACAGGTCTA -> CACAGGTCTAT
CACAGGTCTAT -> ACAGGTCTATC
ACAGGTCTATC -> CAGGTCTATCG
CAGGTCTATCG -> AGGTCTATCGC
AGGTCTATCGC -> GGTCTATCGCG
GGTCTATCGCG -> GTCTATCGCGC
GTCTATCGCGC -> TCTATCGCGCG
TCTATCGCGCG -> CTATCGCGCGA
CTATCGCGCGA -> TATCGCGCGAG
TATCGCGCGAG -> ATCGCGCGAGT
ATCGCGCGAGT -> TCGCGCGAGTG
TCGCGCGAGTG -> CGCGCGAGTGC
CGCGCGAGTGC -> GCGCGAGTGCC
GCGCGAGTGCC -> CGCGAGTGCCT
CGCGAGTGCCT -> GCGAGTGCCTA
GCGAGTGCCTA -> CGAGTGCCTAT
CGAGTGCCTAT -> GAGTGCCTATG
GAGTGCCTATG -> AGTGCCTATGA
AGTGCCTATGA -> GTGCCTATGAG
GTGCCTATGAG -> TGCCTATGAGT
TGCCTATGAGT -> GCCTATGAGTG
GCCTATGAGTG -> CCTATGAGTGT
CCTATGAGTGT -> CTATGAGTGTG
CTATGAGTGTG -> TATGAGTGTGT
TATGAGTGTGT -> ATGAGTGTGTG
ATGAGTGTGTG -> TGAGTGTGTGT
TGAGTGTGTGT -> GAGTGTGTGTC
GAGTGTGTGTC -> AGTGTGTGTCA
AGTGTGTGTCA -> GTGTGTGTCAT
GTGTGTGTCAT -> TGTGTGTCATC
TGTGTGTCATC -> GTGTGTCATCC
GTGTGTCATCC -> TGTGTCATCCA
TGTGTCATCCA -> GTGTCATCCAC
GTGTCATCCAC -> TGTCATCCACA
TGTCATCCACA -> GTCATCCACAG
GTCATCCACAG -> TCATCCACAGT
TCATCCACAGT -> CATCCACAGTA
CATCCACAGTA -> ATCCACAGTAA
ATCCACAGTAA -> TCCACAGTAAA
TCCACAGTAAA -> CCACAGTAAAA
CCACAGTAAAA -> CACAGTAAAAT
CACAGTAAAAT -> ACAGTAAAATT
ACAGTAAAATT -> CAGTAAAATTC
CAGTAAAATTC -> AGTAAAATTCG
AGTAAAATTCG -> GTAAAATTCGT
GTAAAATTCGT -> TAAAATTCGTC
TAAAATTCGTC -> AAAATTCGTCA
AAAATTCGTCA -> AAATTCGTCAA
AAATTCGTCAA -> AATTCGTCAAT
AATTCGTCAAT -> ATTCGTCAATG
ATTCGTCAATG -> TTCGTCAATGG
TTCGTCAATGG -> TCGTCAATGGT
TCGTCAATGGT -> CGTCAATGGTA
CGTCAATGGTA -> GTCAATGGTAA
GTCAATGGTAA -> TCAATGGTAAC
TCAATGGTAAC -> CAATGGTAACG
CAATGGTAACG -> AATGGTAACGT
AATGGTAACGT -> ATGGTAACGTC
ATGGTAACGTC -> TGGTAACGTCA
TGGTAACGTCA -> GGTAACGTCAG
GGTAACGTCAG -> GTAACGTCAGG
GTAACGTCAGG -> TAACGTCAGGG
TAACGTCAGGG -> AACGTCAGGGA
AACGTCAGGGA -> ACGTCAGGGAA
ACGTCAGGGAA -> CGTCAGGGAAT
CGTCAGGGAAT -> GTCAGGGAATT
GTCAGGGAATT -> TCAGGGAATTT
TCAGGGAATTT -> CAGGGAATTTT
CAGGGAATTTT -> AGGGAATTTTA
AGGGAATTTTA -> GGGAATTTTAA
GGGAATTTTAA -> GGAATTTTAAG
GGAATTTTAAG -> GAATTTTAAGG
GAATTTTAAGG -> AATTTTAAGGA
AATTTTAAGGA -> ATTTTAAGGAC
ATTTTAAGGAC -> TTTTAAGGACG
TTTTAAGGACG -> TTTAAGGACGA
TTTAAGGACGA -> TTAAGGACGAG
TTAAGGACGAG -> TAAGGACGAGG
TAAGGACGAGG -> AAGGACGAGGC
AAGGACGAGGC -> AGGACGAGGCT
AGGACGAGGCT -> GGACGAGGCTG
GGACGAGGCTG -> GACGAGGCTGC
GACGAGGCTGC -> ACGAGGCTGCT
ACGAGGCTGCT -> CGAGGCTGCTG
CGAGGCTGCTG -> GAGGCTGCTGT
GAGGCTGCTGT -> AGGCTGCTGTG
AGGCTGCTGTG -> GGCTGCTGTGT
GGCTGCTGTGT -> GCTGCTGTGTA
GCTGCTGTGTA -> CTGCTGTGTAG
CTGCTGTGTAG -> TGCTGTGTAGA
TGCTGTGTAGA -> GCTGTGTAGAC
GCTGTGTAGAC -> CTGTGTAGACG
CTGTGTAGACG -> TGTGTAGACGC
TGTGTAGACGC -> GTGTAGACGCT
GTGTAGACGCT -> TGTAGACGCTA
TGTAGACGCTA -> GTAGACGCTAG
GTAGACGCTAG -> TAGACGCTAGA
TAGACGCTAGA -> AGACGCTAGAA
AGACGCTAGAA -> GACGCTAGAAC
GACGCTAGAAC -> ACGCTAGAACG
ACGCTAGAACG -> CGCTAGAACGG
CGCTAGAACGG -> GCTAGAACGGG
GCTAGAACGGG -> CTAGAACGGGT
CTAGAACGGGT -> TAGAACGGGTT
TAGAACGGGTT -> AGAACGGGTTA
AGAACGGGTTA -> GAACGGGTTAG
GAACGGGTTAG -> AACGGGTTAGG
AACGGGTTAGG -> ACGGGTTAGGG
ACGGGTTAGGG -> CGGGTTAGGGT
CGGGTTAGGGT -> GGGTTAGGGTT
GGGTTAGGGTT -> GGTTAGGGTTA
GGTTAGGGTTA -> GTTAGGGTTAC
GTTAGGGTTAC -> TTAGGGTTACG
TTAGGGTTACG -> TAGGGTTACGC
TAGGGTTACGC -> AGGGTTACGCG
AGGGTTACGCG -> GGGTTACGCGC
GGGTTACGCGC -> GGTTACGCGCC
GGTTACGCGCC -> GTTACGCGCCG
GTTACGCGCCG -> TTACGCGCCGC
TTACGCGCCGC -> TACGCGCCGCA
TACGCGCCGCA -> ACGCGCCGCAC
ACGCGCCGCAC -> CGCGCCGCACC
CGCGCCGCACC -> GCGCCGCACCT
GCGCCGCACCT -> CGCCGCACCTA
CGCCGCACCTA -> GCCGCACCTAC
GCCGCACCTAC -> CCGCACCTACT
CCGCACCTACT -> CGCACCTACTC
CGCACCTACTC -> GCACCTACTCG
GCACCTACTCG -> CACCTACTCGT
CACCTACTCGT -> ACCTACTCGTT
ACCTACTCGTT -> CCTACTCGTTG
CCTACTCGTTG -> CTACTCGTTGC
CTACTCGTTGC -> TACTCGTTGCT
TACTCGTTGCT -> ACTCGTTGCTT
ACTCGTTGCTT -> CTCGTTGCTTC
CTCGTTGCTTC -> TCGTTGCTTCA
TCGTTGCTTCA -> CGTTGCTTCAG
CGTTGCTTCAG -> GTTGCTTCAGG
GTTGCTTCAGG -> TTGCTTCAGGA
TTGCTTCAGGA -> TGCTTCAGGAC
TGCTTCAGGAC -> GCTTCAGGACT
GCTTCAGGACT -> CTTCAGGACTG
CTTCAGGACTG -> TTCAGGACTGC
TTCAGGACTGC -> TCAGGACTGCC
TCAGGACTGCC -> CAGGACTGCCC
CAGGACTGCCC -> AGGACTGCCCG
AGGACTGCCCG -> GGACTGCCCGG
GGACTGCCCGG -> GACTGCCCGGA
GACTGCCCGGA -> ACTGCCCGGAC
ACTGCCCGGAC -> CTGCCCGGACC
CTGCCCGGACC -> TGCCCGGACCC
TGCCCGGACCC -> GCCCGGACCCG
GCCCGGACCCG -> CCCGGACCCGA
CCCGGACCCGA -> CCGGACCCGAA
CCGGACCCGAA -> CGGACCCGAAC
CGGACCCGAAC -> GGACCCGAACT
GGACCCGAACT -> GACCCGAACTC
GACCCGAACTC -> ACCCGAACTCA
ACCCGAACTCA -> CCCGAACTCAA
CCCGAACTCAA -> CCGAACTCAAC
CCGAACTCAAC -> CGAACTCAACC
CGAACTCAACC -> GAACTCAACCC
GAACTCAACCC -> AACTCAACCCT
AACTCAACCCT -> ACTCAACCCTT
ACTCAACCCTT -> CTCAACCCTTC
CTCAACCCTTC -> TCAACCCTTCG
TCAACCCTTCG -> CAACCCTTCGG
CAACCCTTCGG -> AACCCTTCGGG
AACCCTTCGGG -> ACCCTTCGGGA
ACCCTTCGGGA -> CCCTTCGGGAG
CCCTTCGGGAG -> CCTTCGGGAGG
CCTTCGGGAGG -> CTTCGGGAGGA
CTTCGGGAGGA -> TTCGGGAGGAC
TTCGGGAGGAC -> TCGGGAGGACG
TCGGGAGGACG -> CGGGAGGACGT
CGGGAGGACGT -> GGGAGGACGTT
GGGAGGACGTT -> GGAGGACGTTT
GGAGGACGTTT -> GAGGACGTTTT
GAGGACGTTTT -> AGGACGTTTTA
AGGACGTTTTA -> GGACGTTTTAT
GGACGTTTTAT -> GACGTTTTATA
GACGTTTTATA -> ACGTTTTATAG
ACGTTTTATAG -> CGTTTTATAGC
CGTTTTATAGC -> GTTTTATAGCG
GTTTTATAGCG -> TTTTATAGCGC
TTTTATAGCGC -> TTTATAGCGCG
TTTATAGCGCG -> TTATAGCGCGC
TTATAGCGCGC -> TATAGCGCGCC
TATAGCGCGCC -> ATAGCGCGCCT
ATAGCGCGCCT -> TAGCGCGCCTT
TAGCGCGCCTT -> AGCGCGCCTTC
AGCGCGCCTTC -> GCGCGCCTTCT
