ACCTTCGGCCATAGCTATA -> CCTTCGGCCATAGCTATAG
CCTCAGTTAAGGTCGTTCG -> CTCAGTTAAGGTCGTTCGA
TGATGTGATCAGAACTCAG -> GATGTGATCAGAACTCAGC
GGCTATCCATGGCGCTCTT -> GCTATCCATGGCGCTCTTT
TATAGGTCTGATGTCATTG -> ATAGGTCTGATGTCATTGA
AGTACGAACCAGAGCGAAG -> GTACGAACCAGAGCGAAGC
CTTCAATCGAGCTGACGCT -> TTCAATCGAGCTGACGCTC
TTAAGCTTTTCAAAATGTA -> TAAGCTTTTCAAAATGTAG
ACTACGAGACCCAATTGGA -> CTACGAGACCCAATTGGAA
TTTAGTTCTGACTCTCGGA -> TTAGTTCTGACTCTCGGAA
CCAGGCAGCGGTGCGTTAC -> CAGGCAGCGGTGCGTTACG
GATGTGATCAGAACTCAGC -> ATGTGATCAGAACTCAGCC
ATCATGGTCAACCGACCTT -> TCATGGTCAACCGACCTTC
GCTATTTTCAGCTTAAACG -> CTATTTTCAGCTTAAACGT
TTCATGTAACCTGTCAGAA -> TCATGTAACCTGTCAGAAC
CGTCAGTGTCAGGCCCCCG -> GTCAGTGTCAGGCCCCCGA
AGGGTTTTACCCGGCCGTA -> GGGTTTTACCCGGCCGTAT
TGGAGCGTGAAGTAATGGG -> GGAGCGTGAAGTAATGGGT
ATAGAATCTCTATGGCAAC -> TAGAATCTCTATGGCAACG
ATCCCTATAGCATAGCCTA -> TCCCTATAGCATAGCCTAA
ATCGGATGTCTGTCAGCTT -> TCGGATGTCTGTCAGCTTG
CACTTCACCAGCGATTGGT -> ACTTCACCAGCGATTGGTC
TAGCTATGGCATGTTCAAT -> AGCTATGGCATGTTCAATA
AAGATGGACCTTTGCTGAC -> AGATGGACCTTTGCTGACA
AGCAATAACTAAGTTTGGA -> GCAATAACTAAGTTTGGAC
ACGATGCGCTAAGCAATGA -> CGATGCGCTAAGCAATGAC
GGGGGTGCCTCGCTCAATC -> GGGGTGCCTCGCTCAATCG
AGCGATTGGTCATGTACAC -> GCGATTGGTCATGTACACT
ATGGCGCTCTTTACCATAA -> TGGCGCTCTTTACCATAAA
ACGTCCTTCACCCGGCGGG -> CGTCCTTCACCCGGCGGGT
TTCTGTGGCGACGGTGGAA -> TCTGTGGCGACGGTGGAAG
CACCCACGCGTTTGATGCG -> ACCCACGCGTTTGATGCGG
GACTAAACGTGAGCAAGCA -> ACTAAACGTGAGCAAGCAG
CTTATTTCTCTTGCTACAA -> TTATTTCTCTTGCTACAAT
GCAATCATGGTCAACCGAC -> CAATCATGGTCAACCGACC
GGAATAAAATTCCGTCGTC -> GAATAAAATTCCGTCGTCT
TGATCAGAACTCAGCCGCC -> GATCAGAACTCAGCCGCCA
TGCGACAACGTACGTTCCG -> GCGACAACGTACGTTCCGT
CCAATGGAAGACGGGGGTA -> CAATGGAAGACGGGGGTAT
CGTTTGTTCACGATCTCTT -> GTTTGTTCACGATCTCTTA
AAGACCGTCCTTCAATCGA -> AGACCGTCCTTCAATCGAG
TTTTACCCGGCCGTATTCC -> TTTACCCGGCCGTATTCCG
TTAGCGGCCGGAAGCCAAA -> TAGCGGCCGGAAGCCAAAT
GGTCAGGACCTTCGGCCAT -> GTCAGGACCTTCGGCCATA
CGGAACTATAGTCCGCTAT -> GGAACTATAGTCCGCTATT
TGCTCGCATAAGATTTGGG -> GCTCGCATAAGATTTGGGA
TATTAAGTCCGTGAAGGAC -> ATTAAGTCCGTGAAGGACT
GTCCGCTATTAAGTCCGTG -> TCCGCTATTAAGTCCGTGA
CGGCAGAGTTAGGGCACGA -> GGCAGAGTTAGGGCACGAG
CTAAGCAATTAGGCGGTCA -> TAAGCAATTAGGCGGTCAG
CGTATTCCGTCAGTGTCAG -> GTATTCCGTCAGTGTCAGG
ACCTCCCGCAACCATCGCG -> CCTCCCGCAACCATCGCGA
TCGCCTACGGCCAGGCAGC -> CGCCTACGGCCAGGCAGCG
AGGTTTCCTAACCTTATGA -> GGTTTCCTAACCTTATGAC
TGCGATCAACACCCACGCG -> GCGATCAACACCCACGCGT
CAGTACGAACCAGAGCGAA -> AGTACGAACCAGAGCGAAG
CTATAGTCCGCTATTAAGT -> TATAGTCCGCTATTAAGTC
GACGCTCTGGAGAAACTTG -> ACGCTCTGGAGAAACTTGA
GTACACGATCTACTTTGCT -> TACACGATCTACTTTGCTC
CGATGCGCTAAGCAATGAC -> GATGCGCTAAGCAATGACA
GTGGAAGCTAGTTAGCGGC -> TGGAAGCTAGTTAGCGGCC
GTCCAGCTTCTAAATGTCT -> TCCAGCTTCTAAATGTCTG
CGTCGTCTGTCGAACGATG -> GTCGTCTGTCGAACGATGC
TAAAATTCCGTCGTCTGTC -> AAAATTCCGTCGTCTGTCG
GCCTACGGCCAGGCAGCGG -> CCTACGGCCAGGCAGCGGT
ATGGAGCGTGAAGTAATGG -> TGGAGCGTGAAGTAATGGG
ACTAACGATGCGCTAAGCA -> CTAACGATGCGCTAAGCAA
AAAGGTTCGCCGGCGGCGC -> AAGGTTCGCCGGCGGCGCT
CGATGAGATCCGACCGGGG -> GATGAGATCCGACCGGGGT
CCGACATGCGCGTTCATGT -> CGACATGCGCGTTCATGTA
CTCTATGGCAACGTGATTA -> TCTATGGCAACGTGATTAG
TTAGGCGGTCAGGACCTTC -> TAGGCGGTCAGGACCTTCG
TATTCCGTAAGGAGCTATG -> ATTCCGTAAGGAGCTATGG
GATTGGTCATGTACACTAA -> ATTGGTCATGTACACTAAG
TGTAGGCCTCTAACGCGTC -> GTAGGCCTCTAACGCGTCT
GGAAAAGCCAAGAATACTC -> GAAAAGCCAAGAATACTCA
CCGTGTCTCAACCTGAACT -> CGTGTCTCAACCTGAACTA
TGGCTACATTGTGTCGTCT -> GGCTACATTGTGTCGTCTC
AGTAGTTCAGGCAACCCTG -> GTAGTTCAGGCAACCCTGA
GATTACACATGATTTTACC -> ATTACACATGATTTTACCG
CGACCTTCGGCCATAGCTA -> GACCTTCGGCCATAGCTAT
TCTGCAGTAGTTCAGGCAA -> CTGCAGTAGTTCAGGCAAC
GGTGTAGAACTCGTGGGAA -> GTGTAGAACTCGTGGGAAT
CCGGAGAGCGAACAGTACG -> CGGAGAGCGAACAGTACGA
GCATAAGATTTGGGACTTC -> CATAAGATTTGGGACTTCT
CCATGCAGTTCCTCTACGG -> CATGCAGTTCCTCTACGGC
CGTGAGCAAGCAGACTTTA -> GTGAGCAAGCAGACTTTAT
TCCCAGTCCGGGTTAATGC -> CCCAGTCCGGGTTAATGCG
TCTTTACCATAAATCGGAT -> CTTTACCATAAATCGGATG
CGGCCAGGCAGCGGTGCGT -> GGCCAGGCAGCGGTGCGTT
CCCAACACGCAGAGGTCGC -> CCAACACGCAGAGGTCGCC
CAACCTGTAGGCCTCTAAC -> AACCTGTAGGCCTCTAACG
GTTAATGCGATCAACACCC -> TTAATGCGATCAACACCCA
GTCTTGGGTCCTCAGTTAA -> TCTTGGGTCCTCAGTTAAG
AGCTGGATTGCCGTCCAGC -> GCTGGATTGCCGTCCAGCT
CGGATCCTGGCTACATTGT -> GGATCCTGGCTACATTGTG
AATAGAATCTCTATGGCAA -> ATAGAATCTCTATGGCAAC
AATTCCGTCGTCTGTCGAA -> ATTCCGTCGTCTGTCGAAC
CCCCCGATGAGATCCGACC -> CCCCGATGAGATCCGACCG
GTAATGGGTGTAGAACTCG -> TAATGGGTGTAGAACTCGT
ATGCGATCAACACCCACGC -> TGCGATCAACACCCACGCG
ATGCAGTACACGATCTACT -> TGCAGTACACGATCTACTT
TGCCTAGTTCCGGTTATAA -> GCCTAGTTCCGGTTATAAA
TTCGCCGGCGGCGCTAAAG -> TCGCCGGCGGCGCTAAAGT
ACTGGATAGTAGGATAACT -> CTGGATAGTAGGATAACTA
TCGGCCATAGCTATGGCAT -> CGGCCATAGCTATGGCATG
CATTGAGGGCAAGGGCTAT -> ATTGAGGGCAAGGGCTATC
CCGGGTTAATGCGATCAAC -> CGGGTTAATGCGATCAACA
GTAGGATAACTATTCAGAA -> TAGGATAACTATTCAGAAT
AAATTCCGTCGTCTGTCGA -> AATTCCGTCGTCTGTCGAA
CCAACCTGTAGGCCTCTAA -> CAACCTGTAGGCCTCTAAC
TCCGTGTCTCAACCTGAAC -> CCGTGTCTCAACCTGAACT
ACTGGATGACCTTCGGCCA -> CTGGATGACCTTCGGCCAT
GGCCAAACGTCCCCGTGAT -> GCCAAACGTCCCCGTGATT
ACCTTCGGCCATAGCTATT -> CCTTCGGCCATAGCTATTT
TGATAAAAATTGAAATGAA -> GATAAAAATTGAAATGAAT
ATTAGGACCTTATTTCTCT -> TTAGGACCTTATTTCTCTT
TAAGGAGCTATGGCCTTTT -> AAGGAGCTATGGCCTTTTG
TAATTACTACGAGACCCAA -> AATTACTACGAGACCCAAT
AGGCAACCCTGACTGCGCC -> GGCAACCCTGACTGCGCCT
ACGATCTCTTAATTACTAC -> CGATCTCTTAATTACTACG
CTATATATCGACACACCGT -> TATATATCGACACACCGTC
TTATGACAAAGGCGTTTAT -> TATGACAAAGGCGTTTATG
CTGACGTGGACTGCGTCTC -> TGACGTGGACTGCGTCTCG
AGCTAGTTAGCGGCCGGAA -> GCTAGTTAGCGGCCGGAAG
AGTTCAGGCAACCCTGACT -> GTTCAGGCAACCCTGACTG
TTGGAAGGTTTCCTAACCT -> TGGAAGGTTTCCTAACCTT
AACCTGTCAGAACGGTCAC -> ACCTGTCAGAACGGTCACC
GGTTCGCCGGCGGCGCTAA -> GTTCGCCGGCGGCGCTAAA
GTCATGTACACTAAGTGCA -> TCATGTACACTAAGTGCAC
CGAAGGTATTAGGACCTTA -> GAAGGTATTAGGACCTTAT
GTCAACGTGATTCCTTTGA -> TCAACGTGATTCCTTTGAT
CACACCGTCAACGTGATTC -> ACACCGTCAACGTGATTCC
GTTAGTTTATATTCAGGAA -> TTAGTTTATATTCAGGAAA
TAGCTATTTGCTTGCCTGT -> AGCTATTTGCTTGCCTGTA
GGGTGTAGAACTCGTGGGA -> GGTGTAGAACTCGTGGGAA
ATGACAAAGGCGTTTATGC -> TGACAAAGGCGTTTATGCA
CCACCGATTACACATGATT -> CACCGATTACACATGATTT
TAACACCTCCCGCAACCAT -> AACACCTCCCGCAACCATC
GCAGCTCCCAACGTTTGTT -> CAGCTCCCAACGTTTGTTC
CTTTGCTGACACCACCGAT -> TTTGCTGACACCACCGATT
AGACCCAATTGGAAGGTTT -> GACCCAATTGGAAGGTTTC
ACGATGCGCTAAGCAATCA -> CGATGCGCTAAGCAATCAT
GAACGGTCACCGCAAGATG -> AACGGTCACCGCAAGATGG
TGTTAGTTTATATTCAGGA -> GTTAGTTTATATTCAGGAA
CCTATAGCATAGCCTAAAT -> CTATAGCATAGCCTAAATG
TGTCAGGCCCCCGATGAGA -> GTCAGGCCCCCGATGAGAT
TGAGGGCAAGGGCTATCCA -> GAGGGCAAGGGCTATCCAT
TGCCCTGTGAACAAAGGTT -> GCCCTGTGAACAAAGGTTC
CTTGCATAGCTATTTGCTT -> TTGCATAGCTATTTGCTTG
CCGATTACACATGATTTTA -> CGATTACACATGATTTTAC
TGACCTTCGGCCATAGCTA -> GACCTTCGGCCATAGCTAT
ACATGACCTTGCATAGCTA -> CATGACCTTGCATAGCTAT
ATCGAGCTGACGCTCTGGA -> TCGAGCTGACGCTCTGGAG
TCCGGTTATAAACCGCTAT -> CCGGTTATAAACCGCTATG
GTAATCTAAACCCGGATCC -> TAATCTAAACCCGGATCCT
AAGCAGACTTTATCCATGC -> AGCAGACTTTATCCATGCA
AGCTATTTTCAGCTTAAAC -> GCTATTTTCAGCTTAAACG
GCTAAGCAATAACTAAGTT -> CTAAGCAATAACTAAGTTT
TTGTCCCAGTCCGGGTTAA -> TGTCCCAGTCCGGGTTAAT
ATATCAGGGTTTTACCCGG -> TATCAGGGTTTTACCCGGC
GTTAATCGTAGGCGGCAAC -> TTAATCGTAGGCGGCAACG
TCGCATAAGATTTGGGACT -> CGCATAAGATTTGGGACTT
TCAATCGGACCCGGGGGTG -> CAATCGGACCCGGGGGTGC
GCAAAATGAGTCACATGCT -> CAAAATGAGTCACATGCTT
CACTAAGTGCACCGACATG -> ACTAAGTGCACCGACATGC
GGCCATAGCTATTTTCAGC -> GCCATAGCTATTTTCAGCT
TATGTTGTAGAACAACGAT -> ATGTTGTAGAACAACGATG
GGGATGGAGCGTGAAGTAA -> GGATGGAGCGTGAAGTAAT
CTTGTAGACCCGGCAGAGT -> TTGTAGACCCGGCAGAGTT
TGGAAGGTTTCCTAACCTT -> GGAAGGTTTCCTAACCTTA
ATCTACTTTGCTCGCATAA -> TCTACTTTGCTCGCATAAG
CATGTAACCTGTCAGAACG -> ATGTAACCTGTCAGAACGG
TGAAGGACTTTAGTTCTGA -> GAAGGACTTTAGTTCTGAC
TCATGGTCAACCGACCTTC -> CATGGTCAACCGACCTTCG
GCTTGGGGATGGAGCGTGA -> CTTGGGGATGGAGCGTGAA
GTTTATGCATTCGCGTCGA -> TTTATGCATTCGCGTCGAA
TATAAACCGCTATGGATGA -> ATAAACCGCTATGGATGAC
GAATCTGCAGTAGTTCAGG -> AATCTGCAGTAGTTCAGGC
GACTCTCGGAACTTGTAGA -> ACTCTCGGAACTTGTAGAC
CCTCTACGGCAATACGCTA -> CTCTACGGCAATACGCTAT
GTCAACCGACCTTCGGCCA -> TCAACCGACCTTCGGCCAT
TAACCTTATGACAAAGGCG -> AACCTTATGACAAAGGCGT
GTGATTGATATGTTGTAGA -> TGATTGATATGTTGTAGAA
TCCAATGGAAGACGGGGGT -> CCAATGGAAGACGGGGGTA
TGTCGTCGTCAATAGTGCT -> GTCGTCGTCAATAGTGCTG
TGCCCACCGCTTGTAACTC -> GCCCACCGCTTGTAACTCT
ATCGCGTACCTTCTGCGAT -> TCGCGTACCTTCTGCGATT
TTCCGGAGAGCGAACAGTA -> TCCGGAGAGCGAACAGTAC
CATGACCTTGCATAGCTAT -> ATGACCTTGCATAGCTATT
GGACAAGAATTCCCAACAC -> GACAAGAATTCCCAACACG
TCTATGGCAACGTGATTAG -> CTATGGCAACGTGATTAGC
TACCCGGCCGTATTCCGTC -> ACCCGGCCGTATTCCGTCA
CAACGATGCGCTAAGCAAT -> AACGATGCGCTAAGCAATC
TGAGTGCCTAGTTCCGGTT -> GAGTGCCTAGTTCCGGTTA
AAGATATCAGGGTTTTACC -> AGATATCAGGGTTTTACCC
GCCTAAATGGACAAGAATT -> CCTAAATGGACAAGAATTC
CCTCGCTCAATCGGACCCG -> CTCGCTCAATCGGACCCGG
CGATTGGTCATGTACACTA -> GATTGGTCATGTACACTAA
CGACTGGATAGTAGGATAA -> GACTGGATAGTAGGATAAC
TCGCCGGCGGCGCTAAAGT -> CGCCGGCGGCGCTAAAGTC
TGTATTCCGTAAGGAGCTA -> GTATTCCGTAAGGAGCTAT
GGTAATCTAAACCCGGATC -> GTAATCTAAACCCGGATCC
ATTTGCTTGCCTGTATTCC -> TTTGCTTGCCTGTATTCCG
GCGCGTTCATGTAACCTGT -> CGCGTTCATGTAACCTGTC
CAACCGACCTTCGGCCATA -> AACCGACCTTCGGCCATAG
ATCGGCAGCTCCCAACGTT -> TCGGCAGCTCCCAACGTTT
CATAGCTATGGCATGTTCA -> ATAGCTATGGCATGTTCAA
AGGCCCCCGATGAGATCCG -> GGCCCCCGATGAGATCCGA
ATGTCTGTCAGCTTGGGGA -> TGTCTGTCAGCTTGGGGAT
CAAACGTCCCCGTGATTGA -> AAACGTCCCCGTGATTGAT
ATTAAGCTTTTCAAAATGT -> TTAAGCTTTTCAAAATGTA
GCCATAGCTATAGGTCTGA -> CCATAGCTATAGGTCTGAT
TCGGATGTCTGTCAGCTTG -> CGGATGTCTGTCAGCTTGG
TAACTATTCGTGTTAATCG -> AACTATTCGTGTTAATCGT
TTTACCGTCCAATGGAAGA -> TTACCGTCCAATGGAAGAC
AGGAGCTATGGCCTTTTGA -> GGAGCTATGGCCTTTTGAT
AACGATGCGCTAAGCAATA -> ACGATGCGCTAAGCAATAA
TAGTTCTGACTCTCGGAAC -> AGTTCTGACTCTCGGAACT
CCTGGCTACATTGTGTCGT -> CTGGCTACATTGTGTCGTC
GGCTACATTGTGTCGTCTC -> GCTACATTGTGTCGTCTCG
AACTCATCGCGTACCTTCT -> ACTCATCGCGTACCTTCTG
GTTCTGACTCTCGGAACTT -> TTCTGACTCTCGGAACTTG
CTGGATGACCTTCGGCCAT -> TGGATGACCTTCGGCCATA
CGTGAAGGACTTTAGTTCT -> GTGAAGGACTTTAGTTCTG
ATTTTACCGTCCAATGGAA -> TTTTACCGTCCAATGGAAG
GCTATCCCTATAGCATAGC -> CTATCCCTATAGCATAGCC
CCGCTATTAAGTCCGTGAA -> CGCTATTAAGTCCGTGAAG
GCCGTATTCCGTCAGTGTC -> CCGTATTCCGTCAGTGTCA
ACGTCCCCGTGATTGATAT -> CGTCCCCGTGATTGATATG
TTCACCAGCGATTGGTCAT -> TCACCAGCGATTGGTCATG
TTTACCATAAATCGGATGT -> TTACCATAAATCGGATGTC
GGCGGTCAGGACCTTCGGC -> GCGGTCAGGACCTTCGGCC
AACTCAGCCGCCAGCTGAC -> ACTCAGCCGCCAGCTGACG
AGGCGGCAACGTGGCTAAA -> GGCGGCAACGTGGCTAAAT
ACACATGATTTTACCGTCC -> CACATGATTTTACCGTCCA
ACACTCTCAATGGCATCGA -> CACTCTCAATGGCATCGAG
GTGCCTCGCTCAATCGGAC -> TGCCTCGCTCAATCGGACC
GGTCAACCGACCTTCGGCC -> GTCAACCGACCTTCGGCCA
CCGTAAGGAGCTATGGCCT -> CGTAAGGAGCTATGGCCTT
TTCCGTCAGTGTCAGGCCC -> TCCGTCAGTGTCAGGCCCC
GCCGGAAGCCAAATTTTGT -> CCGGAAGCCAAATTTTGTT
GTGAAGTAATGGGTGTAGA -> TGAAGTAATGGGTGTAGAA
TCGACGAAGGAAAAGCCAA -> CGACGAAGGAAAAGCCAAG
ACCGACATGCGCGTTCATG -> CCGACATGCGCGTTCATGT
ATGTAACCTGTCAGAACGG -> TGTAACCTGTCAGAACGGT
TCTTATGGGGCCTCGGTTT -> CTTATGGGGCCTCGGTTTG
TAACGATGCGCTAAGCAAT -> AACGATGCGCTAAGCAATT
CTATCCCTATAGCATAGCC -> TATCCCTATAGCATAGCCT
AAGTTTGGACCTTCGGCCA -> AGTTTGGACCTTCGGCCAT
CGCTCAATCGGACCCGGGG -> GCTCAATCGGACCCGGGGG
GGTCGTTCGACGAAGGAAA -> GTCGTTCGACGAAGGAAAA
ATTTTCAGCTTAAACGTAC -> TTTTCAGCTTAAACGTACA
CCTTCGGCCATAGCTATTT -> CTTCGGCCATAGCTATTTT
CTATCACGGGGTCGTTGTT -> TATCACGGGGTCGTTGTTA
GGCCTCGGTTTGGGGCCAA -> GCCTCGGTTTGGGGCCAAA
CTGCGATTACCTCGACTGG -> TGCGATTACCTCGACTGGA
ACTATAGTCCGCTATTAAG -> CTATAGTCCGCTATTAAGT
AGAGCGAAGCCAGACTGAT -> GAGCGAAGCCAGACTGATA
TCGGCCATAGCTATAGGTC -> CGGCCATAGCTATAGGTCT
AGACTTTATCCATGCAGTT -> GACTTTATCCATGCAGTTC
TATGCATTCGCGTCGAAGG -> ATGCATTCGCGTCGAAGGT
GCGCTAAGCAATAACTAAG -> CGCTAAGCAATAACTAAGT
ATCAGGGTTTTACCCGGCC -> TCAGGGTTTTACCCGGCCG
CATGGTCAACCGACCTTCG -> ATGGTCAACCGACCTTCGG
CACCGCAAGATGGACCTTT -> ACCGCAAGATGGACCTTTG
CGTTACGTCCTTCACCCGG -> GTTACGTCCTTCACCCGGC
TTCCGTGTCTCAACCTGAA -> TCCGTGTCTCAACCTGAAC
ACTCTCAATGGCATCGAGG -> CTCTCAATGGCATCGAGGA
ATAACTAAGTTTGGACCTT -> TAACTAAGTTTGGACCTTC
GGACAAGGTTGGCTGCGAA -> GACAAGGTTGGCTGCGAAA
TCGGACCCGGGGGTGCCCA -> CGGACCCGGGGGTGCCCAC
ACCCGGGGGTGCCCACCGC -> CCCGGGGGTGCCCACCGCT
GAAGCCAAATTTTGTTGTG -> AAGCCAAATTTTGTTGTGA
TTTGCTGACACCACCGATT -> TTGCTGACACCACCGATTA
TCCTCTACGGCAATACGCT -> CCTCTACGGCAATACGCTA
TCAGAATCATAACTATTCG -> CAGAATCATAACTATTCGT
CAGTTAAGGTCGTTCGACG -> AGTTAAGGTCGTTCGACGA
AGGGCAAGGGCTATCCATG -> GGGCAAGGGCTATCCATGG
ATTAGGCGGTCAGGACCTT -> TTAGGCGGTCAGGACCTTC
GGTGCCCTGTGAACAAAGG -> GTGCCCTGTGAACAAAGGT
CGCCTACGGCCAGGCAGCG -> GCCTACGGCCAGGCAGCGG
ACCGTCCTTCAATCGAGCT -> CCGTCCTTCAATCGAGCTG
CGCCTCTTTGAGTGCCTAG -> GCCTCTTTGAGTGCCTAGT
TTACTACGAGACCCAATTG -> TACTACGAGACCCAATTGG
CACCAGCGATTGGTCATGT -> ACCAGCGATTGGTCATGTA
ATTCCCAACACGCAGAGGT -> TTCCCAACACGCAGAGGTC
ATCTCTTAATTACTACGAG -> TCTCTTAATTACTACGAGA
TACGTTCCGTGTCTCAACC -> ACGTTCCGTGTCTCAACCT
ATACTCAGTGGCAAAATGA -> TACTCAGTGGCAAAATGAG
GTCGTCGTCAATAGTGCTG -> TCGTCGTCAATAGTGCTGC
CCTGTGCCTCTCTCAGGAT -> CTGTGCCTCTCTCAGGATC
CGTCGAAGGTATTAGGACC -> GTCGAAGGTATTAGGACCT
TCACCCGTGTTGCGACGGA -> CACCCGTGTTGCGACGGAA
TTGTAACTCTGTCGTCGTC -> TGTAACTCTGTCGTCGTCA
TGATTTTACCGTCCAATGG -> GATTTTACCGTCCAATGGA
GGACATCAGGCGATATGCA -> GACATCAGGCGATATGCAG
ACGTGGCTAAATTAAGCTT -> CGTGGCTAAATTAAGCTTT
TGAGCCTTGACTAAACGTG -> GAGCCTTGACTAAACGTGA
CCCAATTGGAAGGTTTCCT -> CCAATTGGAAGGTTTCCTA
TTGATATGTTGTAGAACAA -> TGATATGTTGTAGAACAAC
GTGTAGAACTCGTGGGAAT -> TGTAGAACTCGTGGGAATA
AATCGTAGGCGGCAACGTG -> ATCGTAGGCGGCAACGTGG
TAAATCGGATGTCTGTCAG -> AAATCGGATGTCTGTCAGC
CGTGGGAATAAAATTCCGT -> GTGGGAATAAAATTCCGTC
GCGTGAAGTAATGGGTGTA -> CGTGAAGTAATGGGTGTAG
GGTAAGATATCAGGGTTTT -> GTAAGATATCAGGGTTTTA
ATCTAAACCCGGATCCTGG -> TCTAAACCCGGATCCTGGC
ACTCAGTGGCAAAATGAGT -> CTCAGTGGCAAAATGAGTC
TCAGCCGCCAGCTGACGTG -> CAGCCGCCAGCTGACGTGG
GGCAGCGGTGCGTTACGTC -> GCAGCGGTGCGTTACGTCC
GTGTCAGGCCCCCGATGAG -> TGTCAGGCCCCCGATGAGA
CATGCGCGTTCATGTAACC -> ATGCGCGTTCATGTAACCT
GAAGTAATGGGTGTAGAAC -> AAGTAATGGGTGTAGAACT
TTTTACCGTCCAATGGAAG -> TTTACCGTCCAATGGAAGA
GTCACATGCTTCGGATGAT -> TCACATGCTTCGGATGATA
TTCGCCCAACCTGTAGGCC -> TCGCCCAACCTGTAGGCCT
GCCGGCGGCGCTAAAGTCT -> CCGGCGGCGCTAAAGTCTT
CTGCCTGTGCCTCTCTCAG -> TGCCTGTGCCTCTCTCAGG
CGCCCAACCTGTAGGCCTC -> GCCCAACCTGTAGGCCTCT
GACCTTGCATAGCTATTTG -> ACCTTGCATAGCTATTTGC
TTTGTTCACGATCTCTTAA -> TTGTTCACGATCTCTTAAT
CAAGGTTGGCTGCGAAAGC -> AAGGTTGGCTGCGAAAGCT
GATAACTATTCAGAATCAT -> ATAACTATTCAGAATCATA
TCTCAACCTGAACTAACGA -> CTCAACCTGAACTAACGAT
CGAGCTGACGCTCTGGAGA -> GAGCTGACGCTCTGGAGAA
TCTCAGGATCGGCAGCTCC -> CTCAGGATCGGCAGCTCCC
CCTAACCTTATGACAAAGG -> CTAACCTTATGACAAAGGC
AAATTTTGTTGTGATGCGT -> AATTTTGTTGTGATGCGTA
TAACCTGTCAGAACGGTCA -> AACCTGTCAGAACGGTCAC
CCCACGCGTTTGATGCGGG -> CCACGCGTTTGATGCGGGA
TGCGATTACCTCGACTGGA -> GCGATTACCTCGACTGGAT
GTGTCGTCTCGGTAAGATA -> TGTCGTCTCGGTAAGATAT
GAGATCCGACCGGGGTCCG -> AGATCCGACCGGGGTCCGG
TTATGCATTCGCGTCGAAG -> TATGCATTCGCGTCGAAGG
CCCACCGCTTGTAACTCTG -> CCACCGCTTGTAACTCTGT
GCGATTGGTCATGTACACT -> CGATTGGTCATGTACACTA
GTTGTGATGCGTATTCGCC -> TTGTGATGCGTATTCGCCC
GTACACTCTCAATGGCATC -> TACACTCTCAATGGCATCG
GTCCGGGTTAATGCGATCA -> TCCGGGTTAATGCGATCAA
CTCCCGCAACCATCGCGAG -> TCCCGCAACCATCGCGAGC
CCTCGGTTTGGGGCCAAAC -> CTCGGTTTGGGGCCAAACG
AGAACAACGATGCGCTAAG -> GAACAACGATGCGCTAAGC
GGATGATAAAAATTGAAAT -> GATGATAAAAATTGAAATG
AGAACTCAGCCGCCAGCTG -> GAACTCAGCCGCCAGCTGA
GGGACTTCTGTGGCGACGG -> GGACTTCTGTGGCGACGGT
AAAAGCCAAGAATACTCAG -> AAAGCCAAGAATACTCAGT
ATGCGCTAAGCAATTAGGC -> TGCGCTAAGCAATTAGGCG
TCGACACACCGTCAACGTG -> CGACACACCGTCAACGTGA
GATGACACGAGGGGGAAGT -> ATGACACGAGGGGGAAGTC
ACGTACACTCTCAATGGCA -> CGTACACTCTCAATGGCAT
GCCAAATTTTGTTGTGATG -> CCAAATTTTGTTGTGATGC
TAACTAAGTTTGGACCTTC -> AACTAAGTTTGGACCTTCG
ACTTCACCAGCGATTGGTC -> CTTCACCAGCGATTGGTCA
GGGAAGTCATGGTGCCCTG -> GGAAGTCATGGTGCCCTGT
GATATCAGGGTTTTACCCG -> ATATCAGGGTTTTACCCGG
CGACACACCGTCAACGTGA -> GACACACCGTCAACGTGAT
ATGGTGCCCTGTGAACAAA -> TGGTGCCCTGTGAACAAAG
AGCTATCCCTATAGCATAG -> GCTATCCCTATAGCATAGC
CTCTCAATGGCATCGAGGA -> TCTCAATGGCATCGAGGAC
TACATTGTGTCGTCTCGGT -> ACATTGTGTCGTCTCGGTA
TCCTTCACCCGGCGGGTAA -> CCTTCACCCGGCGGGTAAT
ATGCGCTAAGCAATGACAA -> TGCGCTAAGCAATGACAAC
AACAAAGGTTCGCCGGCGG -> ACAAAGGTTCGCCGGCGGC
CACCGACATGCGCGTTCAT -> ACCGACATGCGCGTTCATG
ATTTTGTTGTGATGCGTAT -> TTTTGTTGTGATGCGTATT
TACGGCAATACGCTATATA -> ACGGCAATACGCTATATAT
AGACCGTCCTTCAATCGAG -> GACCGTCCTTCAATCGAGC
ACTTGTAGACCCGGCAGAG -> CTTGTAGACCCGGCAGAGT
TGCAGGGCTACATGACCTT -> GCAGGGCTACATGACCTTG
AGAACGGTCACCGCAAGAT -> GAACGGTCACCGCAAGATG
ATGATAAAAATTGAAATGA -> TGATAAAAATTGAAATGAA
TAACTCTGTCGTCGTCAAT -> AACTCTGTCGTCGTCAATA
AACTATTCGTGTTAATCGT -> ACTATTCGTGTTAATCGTA
AAACGTCCCCGTGATTGAT -> AACGTCCCCGTGATTGATA
GCCAAACGTCCCCGTGATT -> CCAAACGTCCCCGTGATTG
GTGCCCACCGCTTGTAACT -> TGCCCACCGCTTGTAACTC
GTCTGGTTTCCGGCCCAGA -> TCTGGTTTCCGGCCCAGAA
ATCCGACCGGGGTCCGGAA -> TCCGACCGGGGTCCGGAAG
CTTTTGATGTGATCAGAAC -> TTTTGATGTGATCAGAACT
AGTCCGCTATTAAGTCCGT -> GTCCGCTATTAAGTCCGTG
CCGTGATTGATATGTTGTA -> CGTGATTGATATGTTGTAG
GCCGCCAGCTGACGTGGAC -> CCGCCAGCTGACGTGGACT
TGGCATGTTCAATAGAATC -> GGCATGTTCAATAGAATCT
TTATAAACCGCTATGGATG -> TATAAACCGCTATGGATGA
CGGGGGTGCCCACCGCTTG -> GGGGGTGCCCACCGCTTGT
TCGACTGGATAGTAGGATA -> CGACTGGATAGTAGGATAA
GCGGCGCTAAAGTCTTGTC -> CGGCGCTAAAGTCTTGTCC
AGCCTAAGAAATTCACTTC -> GCCTAAGAAATTCACTTCA
GGCCATAGCTATCCCTATA -> GCCATAGCTATCCCTATAG
AAGATTTGGGACTTCTGTG -> AGATTTGGGACTTCTGTGG
TGCAGTTCCTCTACGGCAA -> GCAGTTCCTCTACGGCAAT
GATGCGCTAAGCAATAACT -> ATGCGCTAAGCAATAACTA
TACACTAAGTGCACCGACA -> ACACTAAGTGCACCGACAT
TTAATGCGATCAACACCCA -> TAATGCGATCAACACCCAC
ACGTGAGCAAGCAGACTTT -> CGTGAGCAAGCAGACTTTA
AGCTTCGGCTTAAGACCGT -> GCTTCGGCTTAAGACCGTC
CGTTCGACGAAGGAAAAGC -> GTTCGACGAAGGAAAAGCC
CGGTTTGGGGCCAAACGTC -> GGTTTGGGGCCAAACGTCC
GATCGGCAGCTCCCAACGT -> ATCGGCAGCTCCCAACGTT
GACCTTCGGCCATAGCTAT -> ACCTTCGGCCATAGCTATC,ACCTTCGGCCATAGCTATG,ACCTTCGGCCATAGCTATT,ACCTTCGGCCATAGCTATA
AAGCAATAACTAAGTTTGG -> AGCAATAACTAAGTTTGGA
AGTAATGGGTGTAGAACTC -> GTAATGGGTGTAGAACTCG
ACCCGTGTTGCGACGGAAC -> CCCGTGTTGCGACGGAACT
GGCATCGAGGACAAGGTTG -> GCATCGAGGACAAGGTTGG
AAGGTTTCCTAACCTTATG -> AGGTTTCCTAACCTTATGA
GAACTATAGTCCGCTATTA -> AACTATAGTCCGCTATTAA
TCGTTCGACGAAGGAAAAG -> CGTTCGACGAAGGAAAAGC
ACGCTATATATCGACACAC -> CGCTATATATCGACACACC
CCTTGCATAGCTATTTGCT -> CTTGCATAGCTATTTGCTT
GCGCTAAAGTCTTGTCCCA -> CGCTAAAGTCTTGTCCCAG
TTCCGGCCCAGAACTCATC -> TCCGGCCCAGAACTCATCG
ATGTCTGGTTTCCGGCCCA -> TGTCTGGTTTCCGGCCCAG
CAGAACTCAGCCGCCAGCT -> AGAACTCAGCCGCCAGCTG
GACACGAGGGGGAAGTCAT -> ACACGAGGGGGAAGTCATG
CTGAACTAACGATGCGCTA -> TGAACTAACGATGCGCTAA
CTGGTTTCCGGCCCAGAAC -> TGGTTTCCGGCCCAGAACT
AAGAAATTCACTTCACCAG -> AGAAATTCACTTCACCAGC
CGGCAGCTCCCAACGTTTG -> GGCAGCTCCCAACGTTTGT
GCCTGTGCCTCTCTCAGGA -> CCTGTGCCTCTCTCAGGAT
ACACCTCCCGCAACCATCG -> CACCTCCCGCAACCATCGC
CGGGGTCGTTGTTAGTTTA -> GGGGTCGTTGTTAGTTTAT
GAGGACAAGGTTGGCTGCG -> AGGACAAGGTTGGCTGCGA
TCGTCTCGGTAAGATATCA -> CGTCTCGGTAAGATATCAG
ATCGAGGACAAGGTTGGCT -> TCGAGGACAAGGTTGGCTG
ACTCTGTCGTCGTCAATAG -> CTCTGTCGTCGTCAATAGT
GCCTTTTGATGTGATCAGA -> CCTTTTGATGTGATCAGAA
GAGCTGCCTGTGCCTCTCT -> AGCTGCCTGTGCCTCTCTC
GCTAAGCAATGACAACTGG -> CTAAGCAATGACAACTGGA
ATCCTGGCTACATTGTGTC -> TCCTGGCTACATTGTGTCG
CGACATGCGCGTTCATGTA -> GACATGCGCGTTCATGTAA
AATGACAACTGGATGACCT -> ATGACAACTGGATGACCTT
CATAGCCTAAATGGACAAG -> ATAGCCTAAATGGACAAGA
TATCCCTATAGCATAGCCT -> ATCCCTATAGCATAGCCTA
ATGGCATGTTCAATAGAAT -> TGGCATGTTCAATAGAATC
AATCGGATGTCTGTCAGCT -> ATCGGATGTCTGTCAGCTT
CTCAGTGGCAAAATGAGTC -> TCAGTGGCAAAATGAGTCA
GGACCTTTGCTGACACCAC -> GACCTTTGCTGACACCACC
GAAGCTAGTTAGCGGCCGG -> AAGCTAGTTAGCGGCCGGA
TTGTTGTGATGCGTATTCG -> TGTTGTGATGCGTATTCGC
GTATTCGCCCAACCTGTAG -> TATTCGCCCAACCTGTAGG
AAACCCGGATCCTGGCTAC -> AACCCGGATCCTGGCTACA
CCCAGAACTCATCGCGTAC -> CCAGAACTCATCGCGTACC
ACGAGACCCAATTGGAAGG -> CGAGACCCAATTGGAAGGT
GAAGGTCTCTTATGGGGCC -> AAGGTCTCTTATGGGGCCT
TTTCTCTTGCTACAATCAC -> TTCTCTTGCTACAATCACC
TCGGCAGCTCCCAACGTTT -> CGGCAGCTCCCAACGTTTG
CTGTCGTCGTCAATAGTGC -> TGTCGTCGTCAATAGTGCT
GCGCTAAGCAATCATGGTC -> CGCTAAGCAATCATGGTCA
ATAGCATAGCCTAAATGGA -> TAGCATAGCCTAAATGGAC
GTCCTTCAATCGAGCTGAC -> TCCTTCAATCGAGCTGACG
TGTGATCAGAACTCAGCCG -> GTGATCAGAACTCAGCCGC
CGTCCAGCTTCTAAATGTC -> GTCCAGCTTCTAAATGTCT
TATGGCAACGTGATTAGCC -> ATGGCAACGTGATTAGCCT
GAGCCTTGACTAAACGTGA -> AGCCTTGACTAAACGTGAG
ATGCGCTAAGCAATAACTA -> TGCGCTAAGCAATAACTAA
TTACCTCGACTGGATAGTA -> TACCTCGACTGGATAGTAG
AACACCTCCCGCAACCATC -> ACACCTCCCGCAACCATCG
GGATGTCTGTCAGCTTGGG -> GATGTCTGTCAGCTTGGGG
TCCCGCAACCATCGCGAGC -> CCCGCAACCATCGCGAGCT
ACCGCTATGGATGACACGA -> CCGCTATGGATGACACGAG
CAGCTTCTAAATGTCTGGT -> AGCTTCTAAATGTCTGGTT
GACAACTGGATGACCTTCG -> ACAACTGGATGACCTTCGG
CCGGAAGGCTGCGACAACG -> CGGAAGGCTGCGACAACGT
CGGGTTCCGGAGAGCGAAC -> GGGTTCCGGAGAGCGAACA
AGAGTTAGGGCACGAGAGA -> GAGTTAGGGCACGAGAGAC
CGATCTACTTTGCTCGCAT -> GATCTACTTTGCTCGCATA
CAACCCTGACTGCGCCTCT -> AACCCTGACTGCGCCTCTT
ACCAGAGCGAAGCCAGACT -> CCAGAGCGAAGCCAGACTG
GATAGTAGGATAACTATTC -> ATAGTAGGATAACTATTCA
TGGGGCCTCGGTTTGGGGC -> GGGGCCTCGGTTTGGGGCC
TATGCAGTACACGATCTAC -> ATGCAGTACACGATCTACT
TGCGCTAAGCAATGACAAC -> GCGCTAAGCAATGACAACT
GCGAAAGCTTCGGCTTAAG -> CGAAAGCTTCGGCTTAAGA
CGCGTCTATCACGGGGTCG -> GCGTCTATCACGGGGTCGT
GATCTCTTAATTACTACGA -> ATCTCTTAATTACTACGAG
TCGGCCATAGCTATTTTCA -> CGGCCATAGCTATTTTCAG
CAATGGAAGACGGGGGTAT -> AATGGAAGACGGGGGTATT
TAATCTAAACCCGGATCCT -> AATCTAAACCCGGATCCTG
GGCATGTTCAATAGAATCT -> GCATGTTCAATAGAATCTC
TGCTACAATCACCCGTGTT -> GCTACAATCACCCGTGTTG
CCGGAAGCCAAATTTTGTT -> CGGAAGCCAAATTTTGTTG
AATCTGCAGTAGTTCAGGC -> ATCTGCAGTAGTTCAGGCA
TGATATGTTGTAGAACAAC -> GATATGTTGTAGAACAACG
CCGCTATGGATGACACGAG -> CGCTATGGATGACACGAGG
TCCTAACCTTATGACAAAG -> CCTAACCTTATGACAAAGG
TAGCTATAGGTCTGATGTC -> AGCTATAGGTCTGATGTCA
TAACCCAACCGTCTTGGGT -> AACCCAACCGTCTTGGGTC
CATGTACACTAAGTGCACC -> ATGTACACTAAGTGCACCG
CGTCCTTCACCCGGCGGGT -> GTCCTTCACCCGGCGGGTA
GATCTACTTTGCTCGCATA -> ATCTACTTTGCTCGCATAA
GGAAGCCAAATTTTGTTGT -> GAAGCCAAATTTTGTTGTG
GCGTACCTTCTGCGATTAC -> CGTACCTTCTGCGATTACC
CCAATTGGAAGGTTTCCTA -> CAATTGGAAGGTTTCCTAA
GTACCTTCTGCGATTACCT -> TACCTTCTGCGATTACCTC
AGCTCCCAACGTTTGTTCA -> GCTCCCAACGTTTGTTCAC
CTATGGATGACACGAGGGG -> TATGGATGACACGAGGGGG
TGTCAGCTTGGGGATGGAG -> GTCAGCTTGGGGATGGAGC
AGACTTCGAATCTGCAGTA -> GACTTCGAATCTGCAGTAG
TCCCAACGTTTGTTCACGA -> CCCAACGTTTGTTCACGAT
CGTCTGTCGAACGATGCGC -> GTCTGTCGAACGATGCGCT
CAGGCGATATGCAGTACAC -> AGGCGATATGCAGTACACG
AGATGGACCTTTGCTGACA -> GATGGACCTTTGCTGACAC
TCCATGGCGCTCTTTACCA -> CCATGGCGCTCTTTACCAT
GGGCTATCCATGGCGCTCT -> GGCTATCCATGGCGCTCTT
AATAACGGGTTCCGGAGAG -> ATAACGGGTTCCGGAGAGC
ACTATTCGTGTTAATCGTA -> CTATTCGTGTTAATCGTAG
AACGTCCCCGTGATTGATA -> ACGTCCCCGTGATTGATAT
TTCAGGAAACGATGCGCTA -> TCAGGAAACGATGCGCTAA
GACACACCGTCAACGTGAT -> ACACACCGTCAACGTGATT
ACCCTGACTGCGCCTCTTT -> CCCTGACTGCGCCTCTTTG
AATACTCAGTGGCAAAATG -> ATACTCAGTGGCAAAATGA
GCTAAATTAAGCTTTTCAA -> CTAAATTAAGCTTTTCAAA
GAGGGCAAGGGCTATCCAT -> AGGGCAAGGGCTATCCATG
AAACTTGAGTTTATGAGCC -> AACTTGAGTTTATGAGCCT
GAAATTCACTTCACCAGCG -> AAATTCACTTCACCAGCGA
TTCACCCGGCGGGTAATCT -> TCACCCGGCGGGTAATCTA
TGCCTCGCTCAATCGGACC -> GCCTCGCTCAATCGGACCC
CTCTTAATTACTACGAGAC -> TCTTAATTACTACGAGACC
GTACGTTCCGTGTCTCAAC -> TACGTTCCGTGTCTCAACC
TTAATTACTACGAGACCCA -> TAATTACTACGAGACCCAA
AATTAAGCTTTTCAAAATG -> ATTAAGCTTTTCAAAATGT
CGTCGTCAATAGTGCTGCA -> GTCGTCAATAGTGCTGCAG
AAGTGCACCGACATGCGCG -> AGTGCACCGACATGCGCGT
ACTCTCGGAACTTGTAGAC -> CTCTCGGAACTTGTAGACC
CGAGAGACAGGGGGTGCCT -> GAGAGACAGGGGGTGCCTC
ATAAAATTCCGTCGTCTGT -> TAAAATTCCGTCGTCTGTC
TTGATAGCTAACACCTCCC -> TGATAGCTAACACCTCCCG
ATGCGGGACATCAGGCGAT -> TGCGGGACATCAGGCGATA
CTAAAGTCTTGTCCCAGTC -> TAAAGTCTTGTCCCAGTCC
TAGGCCTCTAACGCGTCTA -> AGGCCTCTAACGCGTCTAT
CACGCAGAGGTCGCCTACG -> ACGCAGAGGTCGCCTACGG
CAGGCAGCGGTGCGTTACG -> AGGCAGCGGTGCGTTACGT
GCAAGATGGACCTTTGCTG -> CAAGATGGACCTTTGCTGA
GAAATGAATAACGGGTTCC -> AAATGAATAACGGGTTCCG
GAGCTGACGCTCTGGAGAA -> AGCTGACGCTCTGGAGAAA
CTTATGACAAAGGCGTTTA -> TTATGACAAAGGCGTTTAT
CTCGGAACTTGTAGACCCG -> TCGGAACTTGTAGACCCGG
TTTATGCATTCGCGTCGAA -> TTATGCATTCGCGTCGAAG
GACCCGGGGGTGCCCACCG -> ACCCGGGGGTGCCCACCGC
CTGGCTACATTGTGTCGTC -> TGGCTACATTGTGTCGTCT
CTTCGGCCATAGCTATCCC -> TTCGGCCATAGCTATCCCT
GCTGACGTGGACTGCGTCT -> CTGACGTGGACTGCGTCTC
CTGATGTCATTGAGGGCAA -> TGATGTCATTGAGGGCAAG
CAATGGCATCGAGGACAAG -> AATGGCATCGAGGACAAGG
CGCAGAGGTCGCCTACGGC -> GCAGAGGTCGCCTACGGCC
TGTGGCGACGGTGGAAGCT -> GTGGCGACGGTGGAAGCTA
TGACCTTGCATAGCTATTT -> GACCTTGCATAGCTATTTG
TAAGACCGTCCTTCAATCG -> AAGACCGTCCTTCAATCGA
GAAGGACTTTAGTTCTGAC -> AAGGACTTTAGTTCTGACT
ATGAGTCACATGCTTCGGA -> TGAGTCACATGCTTCGGAT
CAATTAGGCGGTCAGGACC -> AATTAGGCGGTCAGGACCT
CCGTCCAATGGAAGACGGG -> CGTCCAATGGAAGACGGGG
GGTCACCGCAAGATGGACC -> GTCACCGCAAGATGGACCT
AGCTGCCTGTGCCTCTCTC -> GCTGCCTGTGCCTCTCTCA
AGAATTCCCAACACGCAGA -> GAATTCCCAACACGCAGAG
GTGCTGCAGGGCTACATGA -> TGCTGCAGGGCTACATGAC
TGTTGTGATGCGTATTCGC -> GTTGTGATGCGTATTCGCC
CGACGGAACTATAGTCCGC -> GACGGAACTATAGTCCGCT
CAGCGATTGGTCATGTACA -> AGCGATTGGTCATGTACAC
TTCGCGTCGAAGGTATTAG -> TCGCGTCGAAGGTATTAGG
GTCAGAACGGTCACCGCAA -> TCAGAACGGTCACCGCAAG
AGCAATTAGGCGGTCAGGA -> GCAATTAGGCGGTCAGGAC
ATAGCTATTTGCTTGCCTG -> TAGCTATTTGCTTGCCTGT
GCAGACTTTATCCATGCAG -> CAGACTTTATCCATGCAGT
TCTCGGAACTTGTAGACCC -> CTCGGAACTTGTAGACCCG
GGCGGCGCTAAAGTCTTGT -> GCGGCGCTAAAGTCTTGTC
TAGACTTCGAATCTGCAGT -> AGACTTCGAATCTGCAGTA
ACAACTGGATGACCTTCGG -> CAACTGGATGACCTTCGGC
AATTGAAATGAATAACGGG -> ATTGAAATGAATAACGGGT
TGTGTCGTCTCGGTAAGAT -> GTGTCGTCTCGGTAAGATA
ATCAGGCGATATGCAGTAC -> TCAGGCGATATGCAGTACA
TTTTCAGCTTAAACGTACA -> TTTCAGCTTAAACGTACAC
AACCTGAACTAACGATGCG -> ACCTGAACTAACGATGCGC
GACTGCGTCTCGAAGGTCT -> ACTGCGTCTCGAAGGTCTC
CCTCCCGCAACCATCGCGA -> CTCCCGCAACCATCGCGAG
TATTCCGTCAGTGTCAGGC -> ATTCCGTCAGTGTCAGGCC
TCATCGCGTACCTTCTGCG -> CATCGCGTACCTTCTGCGA
ACTGATAGACTTCGAATCT -> CTGATAGACTTCGAATCTG
GAATCTCTATGGCAACGTG -> AATCTCTATGGCAACGTGA
TACCTTCTGCGATTACCTC -> ACCTTCTGCGATTACCTCG
CCAGCTGACGTGGACTGCG -> CAGCTGACGTGGACTGCGT
GCGTCTCGAAGGTCTCTTA -> CGTCTCGAAGGTCTCTTAT
TACGCTATATATCGACACA -> ACGCTATATATCGACACAC
GCGTTTATGCATTCGCGTC -> CGTTTATGCATTCGCGTCG
TCAGCTTAAACGTACACTC -> CAGCTTAAACGTACACTCT
TGGGGCCAAACGTCCCCGT -> GGGGCCAAACGTCCCCGTG
CTGGATAGTAGGATAACTA -> TGGATAGTAGGATAACTAT
TCTAACGCGTCTATCACGG -> CTAACGCGTCTATCACGGG
AAGCCAAATTTTGTTGTGA -> AGCCAAATTTTGTTGTGAT
CGAACGATGCGCTAAGCAA -> GAACGATGCGCTAAGCAAT
TCTGTCAGCTTGGGGATGG -> CTGTCAGCTTGGGGATGGA
GCCTCGCTCAATCGGACCC -> CCTCGCTCAATCGGACCCG
GCGGGTAATCTAAACCCGG -> CGGGTAATCTAAACCCGGA
GATTTGGGACTTCTGTGGC -> ATTTGGGACTTCTGTGGCG
CATTCGCGTCGAAGGTATT -> ATTCGCGTCGAAGGTATTA
AAGGTATTAGGACCTTATT -> AGGTATTAGGACCTTATTT
ACCTGAACTAACGATGCGC -> CCTGAACTAACGATGCGCT
ACCCGGCGGGTAATCTAAA -> CCCGGCGGGTAATCTAAAC
TGACACCACCGATTACACA -> GACACCACCGATTACACAT
GAGGTCGCCTACGGCCAGG -> AGGTCGCCTACGGCCAGGC
CGGGGTCCGGAAGGCTGCG -> GGGGTCCGGAAGGCTGCGA
CGCCAGCTGACGTGGACTG -> GCCAGCTGACGTGGACTGC
AAGCAATCATGGTCAACCG -> AGCAATCATGGTCAACCGA
GTCCCCGTGATTGATATGT -> TCCCCGTGATTGATATGTT
GTAACCTGTCAGAACGGTC -> TAACCTGTCAGAACGGTCA
CGGCGCTAAAGTCTTGTCC -> GGCGCTAAAGTCTTGTCCC
GATGCGCTAAGCAATCATG -> ATGCGCTAAGCAATCATGG
CTATCCATGGCGCTCTTTA -> TATCCATGGCGCTCTTTAC
AGCTATGGCATGTTCAATA -> GCTATGGCATGTTCAATAG
TATCACGGGGTCGTTGTTA -> ATCACGGGGTCGTTGTTAG
GTCCAATGGAAGACGGGGG -> TCCAATGGAAGACGGGGGT
CGTCCTTCAATCGAGCTGA -> GTCCTTCAATCGAGCTGAC
AGGACTTTAGTTCTGACTC -> GGACTTTAGTTCTGACTCT
TTGTGATGCGTATTCGCCC -> TGTGATGCGTATTCGCCCA
AGCTTAAACGTACACTCTC -> GCTTAAACGTACACTCTCA
AGCTAACACCTCCCGCAAC -> GCTAACACCTCCCGCAACC
CGGCCATAGCTATTTTCAG -> GGCCATAGCTATTTTCAGC
GTGCACCGACATGCGCGTT -> TGCACCGACATGCGCGTTC
GTATTAGGACCTTATTTCT -> TATTAGGACCTTATTTCTC
CAAGCAGACTTTATCCATG -> AAGCAGACTTTATCCATGC
GCGTTTGATGCGGGACATC -> CGTTTGATGCGGGACATCA
GACTTTATCCATGCAGTTC -> ACTTTATCCATGCAGTTCC
TGGAAGACGGGGGTATTAC -> GGAAGACGGGGGTATTACG
CAGTTCCTCTACGGCAATA -> AGTTCCTCTACGGCAATAC
TCCGGGTTAATGCGATCAA -> CCGGGTTAATGCGATCAAC
GATAGCTAACACCTCCCGC -> ATAGCTAACACCTCCCGCA
GATGCGTATTCGCCCAACC -> ATGCGTATTCGCCCAACCT
CTAAGCAATAACTAAGTTT -> TAAGCAATAACTAAGTTTG
CAGTACACGATCTACTTTG -> AGTACACGATCTACTTTGC
AATGGACAAGAATTCCCAA -> ATGGACAAGAATTCCCAAC
CGCGAGCTGCCTGTGCCTC -> GCGAGCTGCCTGTGCCTCT
TATATATCGACACACCGTC -> ATATATCGACACACCGTCA
TGAAATGAATAACGGGTTC -> GAAATGAATAACGGGTTCC
CAAATTTTGTTGTGATGCG -> AAATTTTGTTGTGATGCGT
TAAGAAATTCACTTCACCA -> AAGAAATTCACTTCACCAG
ATGCATTCGCGTCGAAGGT -> TGCATTCGCGTCGAAGGTA
TGGGTGTAGAACTCGTGGG -> GGGTGTAGAACTCGTGGGA
TGACGTGGACTGCGTCTCG -> GACGTGGACTGCGTCTCGA
TCCATGCAGTTCCTCTACG -> CCATGCAGTTCCTCTACGG
GCGGTCAGGACCTTCGGCC -> CGGTCAGGACCTTCGGCCA
GTTTGGACCTTCGGCCATA -> TTTGGACCTTCGGCCATAG
AGAAACTTGAGTTTATGAG -> GAAACTTGAGTTTATGAGC
CAAAGGCGTTTATGCATTC -> AAAGGCGTTTATGCATTCG
AAACGATGCGCTAAGCAAT -> AACGATGCGCTAAGCAATA
CCGGCCGTATTCCGTCAGT -> CGGCCGTATTCCGTCAGTG
CTAACCTTATGACAAAGGC -> TAACCTTATGACAAAGGCG
TGTCATTGAGGGCAAGGGC -> GTCATTGAGGGCAAGGGCT
AAGGGCTATCCATGGCGCT -> AGGGCTATCCATGGCGCTC
CCTTCAATCGAGCTGACGC -> CTTCAATCGAGCTGACGCT
GCCAGACTGATAGACTTCG -> CCAGACTGATAGACTTCGA
ACATGATTTTACCGTCCAA -> CATGATTTTACCGTCCAAT
CACTCTCAATGGCATCGAG -> ACTCTCAATGGCATCGAGG
CTATTCGTGTTAATCGTAG -> TATTCGTGTTAATCGTAGG
TAATCGTAGGCGGCAACGT -> AATCGTAGGCGGCAACGTG
CTACTTTGCTCGCATAAGA -> TACTTTGCTCGCATAAGAT
GTAAGATATCAGGGTTTTA -> TAAGATATCAGGGTTTTAC
TTATATTCAGGAAACGATG -> TATATTCAGGAAACGATGC
CCCTGACTGCGCCTCTTTG -> CCTGACTGCGCCTCTTTGA
CTATAGCATAGCCTAAATG -> TATAGCATAGCCTAAATGG
TGCCTGTATTCCGTAAGGA -> GCCTGTATTCCGTAAGGAG
AGGGCTATCCATGGCGCTC -> GGGCTATCCATGGCGCTCT
GACGAAGGAAAAGCCAAGA -> ACGAAGGAAAAGCCAAGAA
CGAGACCCAATTGGAAGGT -> GAGACCCAATTGGAAGGTT
GAACAAAGGTTCGCCGGCG -> AACAAAGGTTCGCCGGCGG
GAACAACGATGCGCTAAGC -> AACAACGATGCGCTAAGCA
TAAAGCTGGATTGCCGTCC -> AAAGCTGGATTGCCGTCCA
GGCGGCAACGTGGCTAAAT -> GCGGCAACGTGGCTAAATT
GATGCGCTAAGCAATGACA -> ATGCGCTAAGCAATGACAA
TCACCAGCGATTGGTCATG -> CACCAGCGATTGGTCATGT
GGCCTCTAACGCGTCTATC -> GCCTCTAACGCGTCTATCA
CGGAACTTGTAGACCCGGC -> GGAACTTGTAGACCCGGCA
TCGGCTTAAGACCGTCCTT -> CGGCTTAAGACCGTCCTTC
TGGATAGTAGGATAACTAT -> GGATAGTAGGATAACTATT
CGGCAATACGCTATATATC -> GGCAATACGCTATATATCG
ATGTTGTAGAACAACGATG -> TGTTGTAGAACAACGATGC
CCAAATTTTGTTGTGATGC -> CAAATTTTGTTGTGATGCG
GGCGACGGTGGAAGCTAGT -> GCGACGGTGGAAGCTAGTT
AGGCGTTTATGCATTCGCG -> GGCGTTTATGCATTCGCGT
ACGGAACTATAGTCCGCTA -> CGGAACTATAGTCCGCTAT
AATGGGTGTAGAACTCGTG -> ATGGGTGTAGAACTCGTGG
ACCTTTGCTGACACCACCG -> CCTTTGCTGACACCACCGA
GATATGCAGTACACGATCT -> ATATGCAGTACACGATCTA
GTCAGGACCTTCGGCCATA -> TCAGGACCTTCGGCCATAG
CACCGCTTGTAACTCTGTC -> ACCGCTTGTAACTCTGTCG
TATATTCAGGAAACGATGC -> ATATTCAGGAAACGATGCG
ATCGACACACCGTCAACGT -> TCGACACACCGTCAACGTG
GTGAGCAAGCAGACTTTAT -> TGAGCAAGCAGACTTTATC
GTGATGCGTATTCGCCCAA -> TGATGCGTATTCGCCCAAC
GACTGGATAGTAGGATAAC -> ACTGGATAGTAGGATAACT
GAACTAACGATGCGCTAAG -> AACTAACGATGCGCTAAGC
AATAGTGCTGCAGGGCTAC -> ATAGTGCTGCAGGGCTACA
GAAACGATGCGCTAAGCAA -> AAACGATGCGCTAAGCAAT
GTTGTTAGTTTATATTCAG -> TTGTTAGTTTATATTCAGG
TTGGCTGCGAAAGCTTCGG -> TGGCTGCGAAAGCTTCGGC
ATAGCTATAGGTCTGATGT -> TAGCTATAGGTCTGATGTC
TAAACCCGGATCCTGGCTA -> AAACCCGGATCCTGGCTAC
CTGACACCACCGATTACAC -> TGACACCACCGATTACACA
TTTCAGCTTAAACGTACAC -> TTCAGCTTAAACGTACACT
GAATAAAATTCCGTCGTCT -> AATAAAATTCCGTCGTCTG
ACTATTCAGAATCATAACT -> CTATTCAGAATCATAACTA
CACCGTCAACGTGATTCCT -> ACCGTCAACGTGATTCCTT
ACAGGGGGTGCCTCGCTCA -> CAGGGGGTGCCTCGCTCAA
TCTTGCTACAATCACCCGT -> CTTGCTACAATCACCCGTG
CTGTATTCCGTAAGGAGCT -> TGTATTCCGTAAGGAGCTA
GAGTCACATGCTTCGGATG -> AGTCACATGCTTCGGATGA
CCTTATGACAAAGGCGTTT -> CTTATGACAAAGGCGTTTA
GAACCAGAGCGAAGCCAGA -> AACCAGAGCGAAGCCAGAC
ACGTTTGTTCACGATCTCT -> CGTTTGTTCACGATCTCTT
GGCGTTTATGCATTCGCGT -> GCGTTTATGCATTCGCGTC
TATTCAGGAAACGATGCGC -> ATTCAGGAAACGATGCGCT
GCGAGCTGCCTGTGCCTCT -> CGAGCTGCCTGTGCCTCTC
GCCTCGGTTTGGGGCCAAA -> CCTCGGTTTGGGGCCAAAC
AAAGCTTCGGCTTAAGACC -> AAGCTTCGGCTTAAGACCG
GATTAGCCTAAGAAATTCA -> ATTAGCCTAAGAAATTCAC
CGGCCGTATTCCGTCAGTG -> GGCCGTATTCCGTCAGTGT
TCGTGGGAATAAAATTCCG -> CGTGGGAATAAAATTCCGT
CATAAATCGGATGTCTGTC -> ATAAATCGGATGTCTGTCA
TCCGGCCCAGAACTCATCG -> CCGGCCCAGAACTCATCGC
AATGAGTCACATGCTTCGG -> ATGAGTCACATGCTTCGGA
CAGGGGGTGCCTCGCTCAA -> AGGGGGTGCCTCGCTCAAT
TCAGCTTGGGGATGGAGCG -> CAGCTTGGGGATGGAGCGT
TATCAGGGTTTTACCCGGC -> ATCAGGGTTTTACCCGGCC
GCGACAACGTACGTTCCGT -> CGACAACGTACGTTCCGTG
GTCTCTTATGGGGCCTCGG -> TCTCTTATGGGGCCTCGGT
TTGAGTTTATGAGCCTTGA -> TGAGTTTATGAGCCTTGAC
CTTGACTAAACGTGAGCAA -> TTGACTAAACGTGAGCAAG
TAAGATTTGGGACTTCTGT -> AAGATTTGGGACTTCTGTG
CCCGCAACCATCGCGAGCT -> CCGCAACCATCGCGAGCTG
CACATGCTTCGGATGATAA -> ACATGCTTCGGATGATAAA
AGTTTATGAGCCTTGACTA -> GTTTATGAGCCTTGACTAA
TATTTTCAGCTTAAACGTA -> ATTTTCAGCTTAAACGTAC
TTCAATAGAATCTCTATGG -> TCAATAGAATCTCTATGGC
CCCTATAGCATAGCCTAAA -> CCTATAGCATAGCCTAAAT
CGGCCATAGCTATCCCTAT -> GGCCATAGCTATCCCTATA
CAGAGCGAAGCCAGACTGA -> AGAGCGAAGCCAGACTGAT
ACCTTCGGCCATAGCTATG -> CCTTCGGCCATAGCTATGG
CGTCTCGAAGGTCTCTTAT -> GTCTCGAAGGTCTCTTATG
GCTTCGGATGATAAAAATT -> CTTCGGATGATAAAAATTG
CGTACACTCTCAATGGCAT -> GTACACTCTCAATGGCATC
GGGTTAATGCGATCAACAC -> GGTTAATGCGATCAACACC
GGATCGGCAGCTCCCAACG -> GATCGGCAGCTCCCAACGT
TACCGTCCAATGGAAGACG -> ACCGTCCAATGGAAGACGG
AACTATTCAGAATCATAAC -> ACTATTCAGAATCATAACT
TTGTAGACCCGGCAGAGTT -> TGTAGACCCGGCAGAGTTA
GACAAAGGCGTTTATGCAT -> ACAAAGGCGTTTATGCATT
GGCAACGTGATTAGCCTAA -> GCAACGTGATTAGCCTAAG
TACATGACCTTGCATAGCT -> ACATGACCTTGCATAGCTA
GAGAAACTTGAGTTTATGA -> AGAAACTTGAGTTTATGAG
CAATGACAACTGGATGACC -> AATGACAACTGGATGACCT
TACACTCTCAATGGCATCG -> ACACTCTCAATGGCATCGA
CTTCTGCGATTACCTCGAC -> TTCTGCGATTACCTCGACT
GGTTTGGGGCCAAACGTCC -> GTTTGGGGCCAAACGTCCC
GTTCGACGAAGGAAAAGCC -> TTCGACGAAGGAAAAGCCA
GGCTTAAGACCGTCCTTCA -> GCTTAAGACCGTCCTTCAA
GAGTGCCTAGTTCCGGTTA -> AGTGCCTAGTTCCGGTTAT
GCGCTCTTTACCATAAATC -> CGCTCTTTACCATAAATCG
TTTCAAAATGTAGGGAATT -> TTCAAAATGTAGGGAATTA
GTGCCCTGTGAACAAAGGT -> TGCCCTGTGAACAAAGGTT
GGGGGAAGTCATGGTGCCC -> GGGGAAGTCATGGTGCCCT
TTTGATGTGATCAGAACTC -> TTGATGTGATCAGAACTCA
TAATGGGTGTAGAACTCGT -> AATGGGTGTAGAACTCGTG
TCTAAACCCGGATCCTGGC -> CTAAACCCGGATCCTGGCT
GCTGCCTGTGCCTCTCTCA -> CTGCCTGTGCCTCTCTCAG
TGAACAAAGGTTCGCCGGC -> GAACAAAGGTTCGCCGGCG
ATGGCATCGAGGACAAGGT -> TGGCATCGAGGACAAGGTT
TGTGATGCGTATTCGCCCA -> GTGATGCGTATTCGCCCAA
TGCTGACACCACCGATTAC -> GCTGACACCACCGATTACA
TTACCCGGCCGTATTCCGT -> TACCCGGCCGTATTCCGTC
TTGCATAGCTATTTGCTTG -> TGCATAGCTATTTGCTTGC
GTCGCCTACGGCCAGGCAG -> TCGCCTACGGCCAGGCAGC
CGCTAAGCAATGACAACTG -> GCTAAGCAATGACAACTGG
GGACCTTCGGCCATAGCTA -> GACCTTCGGCCATAGCTAT,GACCTTCGGCCATAGCTAT
AACCGCTATGGATGACACG -> ACCGCTATGGATGACACGA
TGTCAGAACGGTCACCGCA -> GTCAGAACGGTCACCGCAA
CCTGAACTAACGATGCGCT -> CTGAACTAACGATGCGCTA
CTATTAAGTCCGTGAAGGA -> TATTAAGTCCGTGAAGGAC
ATATGTTGTAGAACAACGA -> TATGTTGTAGAACAACGAT
CAACGTGGCTAAATTAAGC -> AACGTGGCTAAATTAAGCT
GTAAAGCTGGATTGCCGTC -> TAAAGCTGGATTGCCGTCC
TCCTCAGTTAAGGTCGTTC -> CCTCAGTTAAGGTCGTTCG
TACGTCCTTCACCCGGCGG -> ACGTCCTTCACCCGGCGGG
TAAGGTCGTTCGACGAAGG -> AAGGTCGTTCGACGAAGGA
CGCTCTGGAGAAACTTGAG -> GCTCTGGAGAAACTTGAGT
CGCTATATATCGACACACC -> GCTATATATCGACACACCG
TGTACACTAAGTGCACCGA -> GTACACTAAGTGCACCGAC
ATAACTATTCGTGTTAATC -> TAACTATTCGTGTTAATCG
ACAAAGGTTCGCCGGCGGC -> CAAAGGTTCGCCGGCGGCG
ACTTTGCTCGCATAAGATT -> CTTTGCTCGCATAAGATTT
AGGGGGAAGTCATGGTGCC -> GGGGGAAGTCATGGTGCCC
AACCTGTAGGCCTCTAACG -> ACCTGTAGGCCTCTAACGC
TCAACACCCACGCGTTTGA -> CAACACCCACGCGTTTGAT
TAGGGCACGAGAGACAGGG -> AGGGCACGAGAGACAGGGG
AGGTCGTTCGACGAAGGAA -> GGTCGTTCGACGAAGGAAA
GTGGGAATAAAATTCCGTC -> TGGGAATAAAATTCCGTCG
ACCTTATTTCTCTTGCTAC -> CCTTATTTCTCTTGCTACA
AAACGTACACTCTCAATGG -> AACGTACACTCTCAATGGC
AACGTACACTCTCAATGGC -> ACGTACACTCTCAATGGCA
GGCTGCGAAAGCTTCGGCT -> GCTGCGAAAGCTTCGGCTT
TTGAAATGAATAACGGGTT -> TGAAATGAATAACGGGTTC
CGTTTGATGCGGGACATCA -> GTTTGATGCGGGACATCAG
TTCAGAATCATAACTATTC -> TCAGAATCATAACTATTCG
AAATTAAGCTTTTCAAAAT -> AATTAAGCTTTTCAAAATG
CAACGTGATTCCTTTGATA -> AACGTGATTCCTTTGATAG
AAAATGTAGGGAATTAACC -> AAATGTAGGGAATTAACCC
CCCAACGTTTGTTCACGAT -> CCAACGTTTGTTCACGATC
CCGTCAGTGTCAGGCCCCC -> CGTCAGTGTCAGGCCCCCG
GACAACGTACGTTCCGTGT -> ACAACGTACGTTCCGTGTC
GAGCTATGGCCTTTTGATG -> AGCTATGGCCTTTTGATGT
ACCGTCCAATGGAAGACGG -> CCGTCCAATGGAAGACGGG
CGCGTTCATGTAACCTGTC -> GCGTTCATGTAACCTGTCA
CCCGGGGGTGCCCACCGCT -> CCGGGGGTGCCCACCGCTT
GGATGACCTTCGGCCATAG -> GATGACCTTCGGCCATAGC
CGAGCTGCCTGTGCCTCTC -> GAGCTGCCTGTGCCTCTCT
GAAGGTATTAGGACCTTAT -> AAGGTATTAGGACCTTATT
GGCAGAGTTAGGGCACGAG -> GCAGAGTTAGGGCACGAGA
CATGGTGCCCTGTGAACAA -> ATGGTGCCCTGTGAACAAA
ATGATTTTACCGTCCAATG -> TGATTTTACCGTCCAATGG
TAACTATTCAGAATCATAA -> AACTATTCAGAATCATAAC
ATGGAAGACGGGGGTATTA -> TGGAAGACGGGGGTATTAC
GACCTTTGCTGACACCACC -> ACCTTTGCTGACACCACCG
GAATCATAACTATTCGTGT -> AATCATAACTATTCGTGTT
CTACGAGACCCAATTGGAA -> TACGAGACCCAATTGGAAG
AGCTATTTGCTTGCCTGTA -> GCTATTTGCTTGCCTGTAT
TAACGGGTTCCGGAGAGCG -> AACGGGTTCCGGAGAGCGA
CGGCTTAAGACCGTCCTTC -> GGCTTAAGACCGTCCTTCA
GAGAGCGAACAGTACGAAC -> AGAGCGAACAGTACGAACC
TAAGCAATAACTAAGTTTG -> AAGCAATAACTAAGTTTGG
AGACCCGGCAGAGTTAGGG -> GACCCGGCAGAGTTAGGGC
CCCTGTGAACAAAGGTTCG -> CCTGTGAACAAAGGTTCGC
ACGAGAGACAGGGGGTGCC -> CGAGAGACAGGGGGTGCCT
AACAGTACGAACCAGAGCG -> ACAGTACGAACCAGAGCGA
AGTCCGTGAAGGACTTTAG -> GTCCGTGAAGGACTTTAGT
GCATCGAGGACAAGGTTGG -> CATCGAGGACAAGGTTGGC
ATCGGACCCGGGGGTGCCC -> TCGGACCCGGGGGTGCCCA
TAAATTAAGCTTTTCAAAA -> AAATTAAGCTTTTCAAAAT
AACGTGAGCAAGCAGACTT -> ACGTGAGCAAGCAGACTTT
GAAGGCTGCGACAACGTAC -> AAGGCTGCGACAACGTACG
AACGTGATTAGCCTAAGAA -> ACGTGATTAGCCTAAGAAA
GGCAAAATGAGTCACATGC -> GCAAAATGAGTCACATGCT
GTAGGGAATTAACCCAACC -> TAGGGAATTAACCCAACCG
CTGTGCCTCTCTCAGGATC -> TGTGCCTCTCTCAGGATCG
GGGGTCCGGAAGGCTGCGA -> GGGTCCGGAAGGCTGCGAC
GTAGTTCAGGCAACCCTGA -> TAGTTCAGGCAACCCTGAC
ATTGCCGTCCAGCTTCTAA -> TTGCCGTCCAGCTTCTAAA
GCTACAATCACCCGTGTTG -> CTACAATCACCCGTGTTGC
TCCCTATAGCATAGCCTAA -> CCCTATAGCATAGCCTAAA
TCACGGGGTCGTTGTTAGT -> CACGGGGTCGTTGTTAGTT
TGCATAGCTATTTGCTTGC -> GCATAGCTATTTGCTTGCC
TACCATAAATCGGATGTCT -> ACCATAAATCGGATGTCTG
CAGTCCGGGTTAATGCGAT -> AGTCCGGGTTAATGCGATC
GCGGCAACGTGGCTAAATT -> CGGCAACGTGGCTAAATTA
AAATGTAGGGAATTAACCC -> AATGTAGGGAATTAACCCA
GGGAATTAACCCAACCGTC -> GGAATTAACCCAACCGTCT
AGTTCTGACTCTCGGAACT -> GTTCTGACTCTCGGAACTT
ACCACCGATTACACATGAT -> CCACCGATTACACATGATT
CTTGTCCCAGTCCGGGTTA -> TTGTCCCAGTCCGGGTTAA
GCCTCTCTCAGGATCGGCA -> CCTCTCTCAGGATCGGCAG
TAGCCTAAATGGACAAGAA -> AGCCTAAATGGACAAGAAT
TGCGCTAAGCAATCATGGT -> GCGCTAAGCAATCATGGTC
CTAAGCAATGACAACTGGA -> TAAGCAATGACAACTGGAT
TCGTTGTTAGTTTATATTC -> CGTTGTTAGTTTATATTCA
AGACAGGGGGTGCCTCGCT -> GACAGGGGGTGCCTCGCTC
TTAACCCAACCGTCTTGGG -> TAACCCAACCGTCTTGGGT
CTTAAACGTACACTCTCAA -> TTAAACGTACACTCTCAAT
CCGGCGGGTAATCTAAACC -> CGGCGGGTAATCTAAACCC
GTCATTGAGGGCAAGGGCT -> TCATTGAGGGCAAGGGCTA
AGTTAGCGGCCGGAAGCCA -> GTTAGCGGCCGGAAGCCAA
CTCGCTCAATCGGACCCGG -> TCGCTCAATCGGACCCGGG
AGTCATGGTGCCCTGTGAA -> GTCATGGTGCCCTGTGAAC
ACCGTCTTGGGTCCTCAGT -> CCGTCTTGGGTCCTCAGTT
GACTTCGAATCTGCAGTAG -> ACTTCGAATCTGCAGTAGT
GGCAACGTGGCTAAATTAA -> GCAACGTGGCTAAATTAAG
AACTTGAGTTTATGAGCCT -> ACTTGAGTTTATGAGCCTT
CTACATGACCTTGCATAGC -> TACATGACCTTGCATAGCT
AGAACTCGTGGGAATAAAA -> GAACTCGTGGGAATAAAAT
TCATTGAGGGCAAGGGCTA -> CATTGAGGGCAAGGGCTAT
ATTTGGGACTTCTGTGGCG -> TTTGGGACTTCTGTGGCGA
AGAATCTCTATGGCAACGT -> GAATCTCTATGGCAACGTG
TCCGTCGTCTGTCGAACGA -> CCGTCGTCTGTCGAACGAT
CAACACCCACGCGTTTGAT -> AACACCCACGCGTTTGATG
CTGCGCCTCTTTGAGTGCC -> TGCGCCTCTTTGAGTGCCT
GCAATAACTAAGTTTGGAC -> CAATAACTAAGTTTGGACC
CCAAACGTCCCCGTGATTG -> CAAACGTCCCCGTGATTGA
CCTAGTTCCGGTTATAAAC -> CTAGTTCCGGTTATAAACC
GGGTCGTTGTTAGTTTATA -> GGTCGTTGTTAGTTTATAT
CGGAGAGCGAACAGTACGA -> GGAGAGCGAACAGTACGAA
AGAGCGAACAGTACGAACC -> GAGCGAACAGTACGAACCA
AACGTGATTCCTTTGATAG -> ACGTGATTCCTTTGATAGC
AAAATGAGTCACATGCTTC -> AAATGAGTCACATGCTTCG
GCAGTACACGATCTACTTT -> CAGTACACGATCTACTTTG
AGCGAAGCCAGACTGATAG -> GCGAAGCCAGACTGATAGA
GTCCGTGAAGGACTTTAGT -> TCCGTGAAGGACTTTAGTT
TGGGACTTCTGTGGCGACG -> GGGACTTCTGTGGCGACGG
GAGTTAGGGCACGAGAGAC -> AGTTAGGGCACGAGAGACA
GTAGAACAACGATGCGCTA -> TAGAACAACGATGCGCTAA
TTTATATTCAGGAAACGAT -> TTATATTCAGGAAACGATG
ACCGATTACACATGATTTT -> CCGATTACACATGATTTTA
CGTCAATAGTGCTGCAGGG -> GTCAATAGTGCTGCAGGGC
AGCGAACAGTACGAACCAG -> GCGAACAGTACGAACCAGA
GTCTCGGTAAGATATCAGG -> TCTCGGTAAGATATCAGGG
ATGTCATTGAGGGCAAGGG -> TGTCATTGAGGGCAAGGGC
ACTAAACGTGAGCAAGCAG -> CTAAACGTGAGCAAGCAGA
AGGAAAAGCCAAGAATACT -> GGAAAAGCCAAGAATACTC
ATGGACAAGAATTCCCAAC -> TGGACAAGAATTCCCAACA
TACAATCACCCGTGTTGCG -> ACAATCACCCGTGTTGCGA
ACCGACCTTCGGCCATAGC -> CCGACCTTCGGCCATAGCT
TATGGCATGTTCAATAGAA -> ATGGCATGTTCAATAGAAT
CCTCTAACGCGTCTATCAC -> CTCTAACGCGTCTATCACG
CCTCGACTGGATAGTAGGA -> CTCGACTGGATAGTAGGAT
CTTCACCAGCGATTGGTCA -> TTCACCAGCGATTGGTCAT
CATAGCTATTTGCTTGCCT -> ATAGCTATTTGCTTGCCTG
GCTTGTAACTCTGTCGTCG -> CTTGTAACTCTGTCGTCGT
TAGCTAACACCTCCCGCAA -> AGCTAACACCTCCCGCAAC
TCTCTTGCTACAATCACCC -> CTCTTGCTACAATCACCCG
AAGGCGTTTATGCATTCGC -> AGGCGTTTATGCATTCGCG
ATTACCTCGACTGGATAGT -> TTACCTCGACTGGATAGTA
GGAACTTGTAGACCCGGCA -> GAACTTGTAGACCCGGCAG
CATAAGATTTGGGACTTCT -> ATAAGATTTGGGACTTCTG
GCCTCTAACGCGTCTATCA -> CCTCTAACGCGTCTATCAC
TAGTTAGCGGCCGGAAGCC -> AGTTAGCGGCCGGAAGCCA
CCTGACTGCGCCTCTTTGA -> CTGACTGCGCCTCTTTGAG
TGATTGATATGTTGTAGAA -> GATTGATATGTTGTAGAAC
GATGACCTTCGGCCATAGC -> ATGACCTTCGGCCATAGCT
TATCCATGGCGCTCTTTAC -> ATCCATGGCGCTCTTTACC
GGGAATAAAATTCCGTCGT -> GGAATAAAATTCCGTCGTC
ACGCGTTTGATGCGGGACA -> CGCGTTTGATGCGGGACAT
CATAGCTATCCCTATAGCA -> ATAGCTATCCCTATAGCAT
CAGGGCTACATGACCTTGC -> AGGGCTACATGACCTTGCA
TTGGTCATGTACACTAAGT -> TGGTCATGTACACTAAGTG
GTCGTCTCGGTAAGATATC -> TCGTCTCGGTAAGATATCA
AGGGGGTGCCTCGCTCAAT -> GGGGGTGCCTCGCTCAATC
CCGTCCAGCTTCTAAATGT -> CGTCCAGCTTCTAAATGTC
ACGATGCGCTAAGCAATAA -> CGATGCGCTAAGCAATAAC
CACGATCTCTTAATTACTA -> ACGATCTCTTAATTACTAC
GGCCGTATTCCGTCAGTGT -> GCCGTATTCCGTCAGTGTC
GATTCCTTTGATAGCTAAC -> ATTCCTTTGATAGCTAACA
GCCTCTTTGAGTGCCTAGT -> CCTCTTTGAGTGCCTAGTT
GGCAAGGGCTATCCATGGC -> GCAAGGGCTATCCATGGCG
AACGTTTGTTCACGATCTC -> ACGTTTGTTCACGATCTCT
CAGTGTCAGGCCCCCGATG -> AGTGTCAGGCCCCCGATGA
CGGCCGGAAGCCAAATTTT -> GGCCGGAAGCCAAATTTTG
AATAAAATTCCGTCGTCTG -> ATAAAATTCCGTCGTCTGT
CCGGCCCAGAACTCATCGC -> CGGCCCAGAACTCATCGCG
TAAGCAATGACAACTGGAT -> AAGCAATGACAACTGGATG
CCATAGCTATCCCTATAGC -> CATAGCTATCCCTATAGCA
CAGAACGGTCACCGCAAGA -> AGAACGGTCACCGCAAGAT
TACGAACCAGAGCGAAGCC -> ACGAACCAGAGCGAAGCCA
CGGTTATAAACCGCTATGG -> GGTTATAAACCGCTATGGA
AAGTCATGGTGCCCTGTGA -> AGTCATGGTGCCCTGTGAA
TCTCTTATGGGGCCTCGGT -> CTCTTATGGGGCCTCGGTT
TTAATCGTAGGCGGCAACG -> TAATCGTAGGCGGCAACGT
ATAAACCGCTATGGATGAC -> TAAACCGCTATGGATGACA
GCGGCCGGAAGCCAAATTT -> CGGCCGGAAGCCAAATTTT
TGCGCTAAGCAATTAGGCG -> GCGCTAAGCAATTAGGCGG
ATAAGATTTGGGACTTCTG -> TAAGATTTGGGACTTCTGT
AAGTCTTGTCCCAGTCCGG -> AGTCTTGTCCCAGTCCGGG
TCTGTCGAACGATGCGCTA -> CTGTCGAACGATGCGCTAA
TGAGATCCGACCGGGGTCC -> GAGATCCGACCGGGGTCCG
CATGGCGCTCTTTACCATA -> ATGGCGCTCTTTACCATAA
CTCTACGGCAATACGCTAT -> TCTACGGCAATACGCTATA
TGGCGCTCTTTACCATAAA -> GGCGCTCTTTACCATAAAT
ATTCGCCCAACCTGTAGGC -> TTCGCCCAACCTGTAGGCC
GGTTCCGGAGAGCGAACAG -> GTTCCGGAGAGCGAACAGT
CGTAGGCGGCAACGTGGCT -> GTAGGCGGCAACGTGGCTA
CTGTCGAACGATGCGCTAA -> TGTCGAACGATGCGCTAAG
CTAAACCCGGATCCTGGCT -> TAAACCCGGATCCTGGCTA
GATGCGCTAAGCAATTAGG -> ATGCGCTAAGCAATTAGGC
TTTTGATGTGATCAGAACT -> TTTGATGTGATCAGAACTC
AAAGCCAAGAATACTCAGT -> AAGCCAAGAATACTCAGTG
ACGTACGTTCCGTGTCTCA -> CGTACGTTCCGTGTCTCAA
AGTTTATATTCAGGAAACG -> GTTTATATTCAGGAAACGA
TGGAGAAACTTGAGTTTAT -> GGAGAAACTTGAGTTTATG
GCTTTTCAAAATGTAGGGA -> CTTTTCAAAATGTAGGGAA
ACAATCACCCGTGTTGCGA -> CAATCACCCGTGTTGCGAC
GTTGTAGAACAACGATGCG -> TTGTAGAACAACGATGCGC
TGGACCTTCGGCCATAGCT -> GGACCTTCGGCCATAGCTA
CTCTTTGAGTGCCTAGTTC -> TCTTTGAGTGCCTAGTTCC
AGCTATAGGTCTGATGTCA -> GCTATAGGTCTGATGTCAT
GTCCCAGTCCGGGTTAATG -> TCCCAGTCCGGGTTAATGC
TATTCAGAATCATAACTAT -> ATTCAGAATCATAACTATT
TTGAGGGCAAGGGCTATCC -> TGAGGGCAAGGGCTATCCA
GAATAACGGGTTCCGGAGA -> AATAACGGGTTCCGGAGAG
GTGGCGACGGTGGAAGCTA -> TGGCGACGGTGGAAGCTAG
GTCTCAACCTGAACTAACG -> TCTCAACCTGAACTAACGA
CACATGATTTTACCGTCCA -> ACATGATTTTACCGTCCAA
CAGGCAACCCTGACTGCGC -> AGGCAACCCTGACTGCGCC
TTTGGGGCCAAACGTCCCC -> TTGGGGCCAAACGTCCCCG
GACGGAACTATAGTCCGCT -> ACGGAACTATAGTCCGCTA
GAGAGACAGGGGGTGCCTC -> AGAGACAGGGGGTGCCTCG
CGTGTTGCGACGGAACTAT -> GTGTTGCGACGGAACTATA
AATTTTGTTGTGATGCGTA -> ATTTTGTTGTGATGCGTAT
CGCTAAGCAATTAGGCGGT -> GCTAAGCAATTAGGCGGTC
ATTGGAAGGTTTCCTAACC -> TTGGAAGGTTTCCTAACCT
CATCGCGAGCTGCCTGTGC -> ATCGCGAGCTGCCTGTGCC
CTCGTGGGAATAAAATTCC -> TCGTGGGAATAAAATTCCG
CTGTGGCGACGGTGGAAGC -> TGTGGCGACGGTGGAAGCT
TGGAAGCTAGTTAGCGGCC -> GGAAGCTAGTTAGCGGCCG
AAAATTCCGTCGTCTGTCG -> AAATTCCGTCGTCTGTCGA
GAACTCGTGGGAATAAAAT -> AACTCGTGGGAATAAAATT
TTCGACGAAGGAAAAGCCA -> TCGACGAAGGAAAAGCCAA
TTAAGTCCGTGAAGGACTT -> TAAGTCCGTGAAGGACTTT
GTGATCAGAACTCAGCCGC -> TGATCAGAACTCAGCCGCC
AATACGCTATATATCGACA -> ATACGCTATATATCGACAC
GACGGTGGAAGCTAGTTAG -> ACGGTGGAAGCTAGTTAGC
GGTGCCTCGCTCAATCGGA -> GTGCCTCGCTCAATCGGAC
CACCGATTACACATGATTT -> ACCGATTACACATGATTTT
CGTACCTTCTGCGATTACC -> GTACCTTCTGCGATTACCT
TTCTCTTGCTACAATCACC -> TCTCTTGCTACAATCACCC
ATTGATATGTTGTAGAACA -> TTGATATGTTGTAGAACAA
ACGATCTACTTTGCTCGCA -> CGATCTACTTTGCTCGCAT
GGATAGTAGGATAACTATT -> GATAGTAGGATAACTATTC
TATCCATGCAGTTCCTCTA -> ATCCATGCAGTTCCTCTAC
CCTAAGAAATTCACTTCAC -> CTAAGAAATTCACTTCACC
TGTCTCAACCTGAACTAAC -> GTCTCAACCTGAACTAACG
GATGCGGGACATCAGGCGA -> ATGCGGGACATCAGGCGAT
GCAGAGTTAGGGCACGAGA -> CAGAGTTAGGGCACGAGAG
TGCGCTAAGCAATAACTAA -> GCGCTAAGCAATAACTAAG
CAATCGGACCCGGGGGTGC -> AATCGGACCCGGGGGTGCC
ATGGCCTTTTGATGTGATC -> TGGCCTTTTGATGTGATCA
CCATAGCTATGGCATGTTC -> CATAGCTATGGCATGTTCA
ACTCAGCCGCCAGCTGACG -> CTCAGCCGCCAGCTGACGT
TTGGGGCCAAACGTCCCCG -> TGGGGCCAAACGTCCCCGT
TGTCTGTCAGCTTGGGGAT -> GTCTGTCAGCTTGGGGATG
CGAGGACAAGGTTGGCTGC -> GAGGACAAGGTTGGCTGCG
GTGCGTTACGTCCTTCACC -> TGCGTTACGTCCTTCACCC
GCAATTAGGCGGTCAGGAC -> CAATTAGGCGGTCAGGACC
AACTATAGTCCGCTATTAA -> ACTATAGTCCGCTATTAAG
CTATTCAGAATCATAACTA -> TATTCAGAATCATAACTAT
CCTTCGGCCATAGCTATAG -> CTTCGGCCATAGCTATAGG
CTGCGACAACGTACGTTCC -> TGCGACAACGTACGTTCCG
AAGCTAGTTAGCGGCCGGA -> AGCTAGTTAGCGGCCGGAA
TTGAGTGCCTAGTTCCGGT -> TGAGTGCCTAGTTCCGGTT
CCGGGGGTGCCCACCGCTT -> CGGGGGTGCCCACCGCTTG
GCGATATGCAGTACACGAT -> CGATATGCAGTACACGATC
ACCGTCAACGTGATTCCTT -> CCGTCAACGTGATTCCTTT
CAGGGTTTTACCCGGCCGT -> AGGGTTTTACCCGGCCGTA
CGGCGGCGCTAAAGTCTTG -> GGCGGCGCTAAAGTCTTGT
TATTAGGACCTTATTTCTC -> ATTAGGACCTTATTTCTCT
AGCCGCCAGCTGACGTGGA -> GCCGCCAGCTGACGTGGAC
TCAGGACCTTCGGCCATAG -> CAGGACCTTCGGCCATAGC
ACACTAAGTGCACCGACAT -> CACTAAGTGCACCGACATG
TAAATGTCTGGTTTCCGGC -> AAATGTCTGGTTTCCGGCC
TCTGTGGCGACGGTGGAAG -> CTGTGGCGACGGTGGAAGC
CGTTCCGTGTCTCAACCTG -> GTTCCGTGTCTCAACCTGA
TCTGGAGAAACTTGAGTTT -> CTGGAGAAACTTGAGTTTA
CCCGTGATTGATATGTTGT -> CCGTGATTGATATGTTGTA
CCCGATGAGATCCGACCGG -> CCGATGAGATCCGACCGGG
ATGGATGACACGAGGGGGA -> TGGATGACACGAGGGGGAA
CTGTCAGAACGGTCACCGC -> TGTCAGAACGGTCACCGCA
AACGATGCGCTAAGCAATT -> ACGATGCGCTAAGCAATTA
TTACCATAAATCGGATGTC -> TACCATAAATCGGATGTCT
ACCTTATGACAAAGGCGTT -> CCTTATGACAAAGGCGTTT
TGGCATCGAGGACAAGGTT -> GGCATCGAGGACAAGGTTG
GACTTTAGTTCTGACTCTC -> ACTTTAGTTCTGACTCTCG
TCTGTCGTCGTCAATAGTG -> CTGTCGTCGTCAATAGTGC
ATAGCTATCCCTATAGCAT -> TAGCTATCCCTATAGCATA
TGTCTGGTTTCCGGCCCAG -> GTCTGGTTTCCGGCCCAGA
GCTGGATTGCCGTCCAGCT -> CTGGATTGCCGTCCAGCTT
TGCACCGACATGCGCGTTC -> GCACCGACATGCGCGTTCA
ATGAGCCTTGACTAAACGT -> TGAGCCTTGACTAAACGTG
CAACCGTCTTGGGTCCTCA -> AACCGTCTTGGGTCCTCAG
AGCTTCTAAATGTCTGGTT -> GCTTCTAAATGTCTGGTTT
CTTCGGCCATAGCTATTTT -> TTCGGCCATAGCTATTTTC
ATTCGTGTTAATCGTAGGC -> TTCGTGTTAATCGTAGGCG
CATAGCTATAGGTCTGATG -> ATAGCTATAGGTCTGATGT
ATGGGTGTAGAACTCGTGG -> TGGGTGTAGAACTCGTGGG
AAGGTTGGCTGCGAAAGCT -> AGGTTGGCTGCGAAAGCTT
TAAAGTCTTGTCCCAGTCC -> AAAGTCTTGTCCCAGTCCG
AATTAGGCGGTCAGGACCT -> ATTAGGCGGTCAGGACCTT
ACCAGCGATTGGTCATGTA -> CCAGCGATTGGTCATGTAC
CTCTAACGCGTCTATCACG -> TCTAACGCGTCTATCACGG
AAACGTGAGCAAGCAGACT -> AACGTGAGCAAGCAGACTT
GTCTATCACGGGGTCGTTG -> TCTATCACGGGGTCGTTGT
CTACGGCAATACGCTATAT -> TACGGCAATACGCTATATA
GGCCGGAAGCCAAATTTTG -> GCCGGAAGCCAAATTTTGT
TCGCGTCGAAGGTATTAGG -> CGCGTCGAAGGTATTAGGA
TCGGAACTTGTAGACCCGG -> CGGAACTTGTAGACCCGGC
ATTCCGTCAGTGTCAGGCC -> TTCCGTCAGTGTCAGGCCC
TTCGAATCTGCAGTAGTTC -> TCGAATCTGCAGTAGTTCA
AGTTCCTCTACGGCAATAC -> GTTCCTCTACGGCAATACG
GTGGCTAAATTAAGCTTTT -> TGGCTAAATTAAGCTTTTC
AAAGCTGGATTGCCGTCCA -> AAGCTGGATTGCCGTCCAG
TAAGTTTGGACCTTCGGCC -> AAGTTTGGACCTTCGGCCA
ACCTGTAGGCCTCTAACGC -> CCTGTAGGCCTCTAACGCG
ATCGTAGGCGGCAACGTGG -> TCGTAGGCGGCAACGTGGC
CGAAGCCAGACTGATAGAC -> GAAGCCAGACTGATAGACT
CCTGTGAACAAAGGTTCGC -> CTGTGAACAAAGGTTCGCC
TACGAGACCCAATTGGAAG -> ACGAGACCCAATTGGAAGG
CAATTGGAAGGTTTCCTAA -> AATTGGAAGGTTTCCTAAC
CGCTAAGCAATCATGGTCA -> GCTAAGCAATCATGGTCAA
ACGGGTTCCGGAGAGCGAA -> CGGGTTCCGGAGAGCGAAC
TTCTAAATGTCTGGTTTCC -> TCTAAATGTCTGGTTTCCG
GCAATACGCTATATATCGA -> CAATACGCTATATATCGAC
ACTGCGCCTCTTTGAGTGC -> CTGCGCCTCTTTGAGTGCC
GTAACTCTGTCGTCGTCAA -> TAACTCTGTCGTCGTCAAT
GGCTACATGACCTTGCATA -> GCTACATGACCTTGCATAG
CGTGAAGTAATGGGTGTAG -> GTGAAGTAATGGGTGTAGA
TATAGTCCGCTATTAAGTC -> ATAGTCCGCTATTAAGTCC
GTTCCGTGTCTCAACCTGA -> TTCCGTGTCTCAACCTGAA
GTTTGTTCACGATCTCTTA -> TTTGTTCACGATCTCTTAA
GCTCTGGAGAAACTTGAGT -> CTCTGGAGAAACTTGAGTT
GAACAGTACGAACCAGAGC -> AACAGTACGAACCAGAGCG
CAACGTTTGTTCACGATCT -> AACGTTTGTTCACGATCTC
GGGGTCGTTGTTAGTTTAT -> GGGTCGTTGTTAGTTTATA
GTGTTGCGACGGAACTATA -> TGTTGCGACGGAACTATAG
TGATGCGTATTCGCCCAAC -> GATGCGTATTCGCCCAACC
AATCATAACTATTCGTGTT -> ATCATAACTATTCGTGTTA
CGTATTCGCCCAACCTGTA -> GTATTCGCCCAACCTGTAG
TCGGATGATAAAAATTGAA -> CGGATGATAAAAATTGAAA
AGGCTGCGACAACGTACGT -> GGCTGCGACAACGTACGTT
TTTGATAGCTAACACCTCC -> TTGATAGCTAACACCTCCC
CGGATGTCTGTCAGCTTGG -> GGATGTCTGTCAGCTTGGG
TTATGAGCCTTGACTAAAC -> TATGAGCCTTGACTAAACG
GTACGAACCAGAGCGAAGC -> TACGAACCAGAGCGAAGCC
GCTATTAAGTCCGTGAAGG -> CTATTAAGTCCGTGAAGGA
TGCCGTCCAGCTTCTAAAT -> GCCGTCCAGCTTCTAAATG
GATTACCTCGACTGGATAG -> ATTACCTCGACTGGATAGT
TCTGATGTCATTGAGGGCA -> CTGATGTCATTGAGGGCAA
GCGACGGTGGAAGCTAGTT -> CGACGGTGGAAGCTAGTTA
GCGCTAAGCAATTAGGCGG -> CGCTAAGCAATTAGGCGGT
AGCAATGACAACTGGATGA -> GCAATGACAACTGGATGAC
CAGGCCCCCGATGAGATCC -> AGGCCCCCGATGAGATCCG
CCCCGTGATTGATATGTTG -> CCCGTGATTGATATGTTGT
GAACGATGCGCTAAGCAAT -> AACGATGCGCTAAGCAATG
CCGGTTATAAACCGCTATG -> CGGTTATAAACCGCTATGG
CTGCAGTAGTTCAGGCAAC -> TGCAGTAGTTCAGGCAACC
ATTGAAATGAATAACGGGT -> TTGAAATGAATAACGGGTT
GGGGATGGAGCGTGAAGTA -> GGGATGGAGCGTGAAGTAA
TCAGTGGCAAAATGAGTCA -> CAGTGGCAAAATGAGTCAC
ACACGAGGGGGAAGTCATG -> CACGAGGGGGAAGTCATGG
CGCTATTAAGTCCGTGAAG -> GCTATTAAGTCCGTGAAGG
TGCTTGCCTGTATTCCGTA -> GCTTGCCTGTATTCCGTAA
GAACTTGTAGACCCGGCAG -> AACTTGTAGACCCGGCAGA
AGCATAGCCTAAATGGACA -> GCATAGCCTAAATGGACAA
GTGATTAGCCTAAGAAATT -> TGATTAGCCTAAGAAATTC
AACAACGATGCGCTAAGCA -> ACAACGATGCGCTAAGCAA
GTTTTACCCGGCCGTATTC -> TTTTACCCGGCCGTATTCC
GCAGGGCTACATGACCTTG -> CAGGGCTACATGACCTTGC
CCAACGTTTGTTCACGATC -> CAACGTTTGTTCACGATCT
GGCCTTTTGATGTGATCAG -> GCCTTTTGATGTGATCAGA
CGCGTACCTTCTGCGATTA -> GCGTACCTTCTGCGATTAC
ACGCTCTGGAGAAACTTGA -> CGCTCTGGAGAAACTTGAG
GTTTCCTAACCTTATGACA -> TTTCCTAACCTTATGACAA
ACTAAGTTTGGACCTTCGG -> CTAAGTTTGGACCTTCGGC
TAGCATAGCCTAAATGGAC -> AGCATAGCCTAAATGGACA
AGGTCTGATGTCATTGAGG -> GGTCTGATGTCATTGAGGG
CCAGAGCGAAGCCAGACTG -> CAGAGCGAAGCCAGACTGA
TTCAGGCAACCCTGACTGC -> TCAGGCAACCCTGACTGCG
TGATTCCTTTGATAGCTAA -> GATTCCTTTGATAGCTAAC
CTTCTAAATGTCTGGTTTC -> TTCTAAATGTCTGGTTTCC
TGCGACGGAACTATAGTCC -> GCGACGGAACTATAGTCCG
TTTGGACCTTCGGCCATAG -> TTGGACCTTCGGCCATAGC
CCCGGATCCTGGCTACATT -> CCGGATCCTGGCTACATTG
CTTCGGCCATAGCTATAGG -> TTCGGCCATAGCTATAGGT
TTCCTAACCTTATGACAAA -> TCCTAACCTTATGACAAAG
CGTACGTTCCGTGTCTCAA -> GTACGTTCCGTGTCTCAAC
CAATAGTGCTGCAGGGCTA -> AATAGTGCTGCAGGGCTAC
GTTAAGGTCGTTCGACGAA -> TTAAGGTCGTTCGACGAAG
CTCGAAGGTCTCTTATGGG -> TCGAAGGTCTCTTATGGGG
CCAGAACTCATCGCGTACC -> CAGAACTCATCGCGTACCT
CGTAAGGAGCTATGGCCTT -> GTAAGGAGCTATGGCCTTT
TCTCTATGGCAACGTGATT -> CTCTATGGCAACGTGATTA
CGTGATTAGCCTAAGAAAT -> GTGATTAGCCTAAGAAATT
CAGTGGCAAAATGAGTCAC -> AGTGGCAAAATGAGTCACA
AACGATGCGCTAAGCAATC -> ACGATGCGCTAAGCAATCA
CGATCAACACCCACGCGTT -> GATCAACACCCACGCGTTT
CCGTCAACGTGATTCCTTT -> CGTCAACGTGATTCCTTTG
TCAGGCAACCCTGACTGCG -> CAGGCAACCCTGACTGCGC
GGCACGAGAGACAGGGGGT -> GCACGAGAGACAGGGGGTG
GCTCAATCGGACCCGGGGG -> CTCAATCGGACCCGGGGGT
ACAGTACGAACCAGAGCGA -> CAGTACGAACCAGAGCGAA
AGGTATTAGGACCTTATTT -> GGTATTAGGACCTTATTTC
TCACCGCAAGATGGACCTT -> CACCGCAAGATGGACCTTT
AAAATTGAAATGAATAACG -> AAATTGAAATGAATAACGG
CTGACTCTCGGAACTTGTA -> TGACTCTCGGAACTTGTAG
AAGCAATTAGGCGGTCAGG -> AGCAATTAGGCGGTCAGGA
AGGACAAGGTTGGCTGCGA -> GGACAAGGTTGGCTGCGAA
CCGCTTGTAACTCTGTCGT -> CGCTTGTAACTCTGTCGTC
GGTCCGGAAGGCTGCGACA -> GTCCGGAAGGCTGCGACAA
GTCTGTCGAACGATGCGCT -> TCTGTCGAACGATGCGCTA
TTGTAGAACAACGATGCGC -> TGTAGAACAACGATGCGCT
TCTCTCAGGATCGGCAGCT -> CTCTCAGGATCGGCAGCTC
GGGTGCCCACCGCTTGTAA -> GGTGCCCACCGCTTGTAAC
AATTCCCAACACGCAGAGG -> ATTCCCAACACGCAGAGGT
CTGCAGGGCTACATGACCT -> TGCAGGGCTACATGACCTT
AAGAATACTCAGTGGCAAA -> AGAATACTCAGTGGCAAAA
CTTCGGCTTAAGACCGTCC -> TTCGGCTTAAGACCGTCCT
AGTCACATGCTTCGGATGA -> GTCACATGCTTCGGATGAT
AGCAAGCAGACTTTATCCA -> GCAAGCAGACTTTATCCAT
ACGGCCAGGCAGCGGTGCG -> CGGCCAGGCAGCGGTGCGT
CGCAACCATCGCGAGCTGC -> GCAACCATCGCGAGCTGCC
TGTCCCAGTCCGGGTTAAT -> GTCCCAGTCCGGGTTAATG
CCAACACGCAGAGGTCGCC -> CAACACGCAGAGGTCGCCT
TCATGTACACTAAGTGCAC -> CATGTACACTAAGTGCACC
AGGAAACGATGCGCTAAGC -> GGAAACGATGCGCTAAGCA
TTTTCAAAATGTAGGGAAT -> TTTCAAAATGTAGGGAATT
CCTGTAGGCCTCTAACGCG -> CTGTAGGCCTCTAACGCGT
AGCAGACTTTATCCATGCA -> GCAGACTTTATCCATGCAG
GCCTAAGAAATTCACTTCA -> CCTAAGAAATTCACTTCAC
GCCAGCTGACGTGGACTGC -> CCAGCTGACGTGGACTGCG
CGTGTTAATCGTAGGCGGC -> GTGTTAATCGTAGGCGGCA
AACTCGTGGGAATAAAATT -> ACTCGTGGGAATAAAATTC
CGCTTGTAACTCTGTCGTC -> GCTTGTAACTCTGTCGTCG
GAGTTTATGAGCCTTGACT -> AGTTTATGAGCCTTGACTA
GGCAGCTCCCAACGTTTGT -> GCAGCTCCCAACGTTTGTT
TCTTGGGTCCTCAGTTAAG -> CTTGGGTCCTCAGTTAAGG
TATGACAAAGGCGTTTATG -> ATGACAAAGGCGTTTATGC
ATAGTGCTGCAGGGCTACA -> TAGTGCTGCAGGGCTACAT
CAACGTACGTTCCGTGTCT -> AACGTACGTTCCGTGTCTC
TTATTTCTCTTGCTACAAT -> TATTTCTCTTGCTACAATC
ATGGTCAACCGACCTTCGG -> TGGTCAACCGACCTTCGGC
TGTAACTCTGTCGTCGTCA -> GTAACTCTGTCGTCGTCAA
CGGTCACCGCAAGATGGAC -> GGTCACCGCAAGATGGACC
TCAATAGTGCTGCAGGGCT -> CAATAGTGCTGCAGGGCTA
CTAGTTAGCGGCCGGAAGC -> TAGTTAGCGGCCGGAAGCC
CCAACCGTCTTGGGTCCTC -> CAACCGTCTTGGGTCCTCA
TTTCCTAACCTTATGACAA -> TTCCTAACCTTATGACAAA
GGAATTAACCCAACCGTCT -> GAATTAACCCAACCGTCTT
ACGCAGAGGTCGCCTACGG -> CGCAGAGGTCGCCTACGGC
CTAACACCTCCCGCAACCA -> TAACACCTCCCGCAACCAT
TTACCGTCCAATGGAAGAC -> TACCGTCCAATGGAAGACG
TTCAATCGAGCTGACGCTC -> TCAATCGAGCTGACGCTCT
CCGACCGGGGTCCGGAAGG -> CGACCGGGGTCCGGAAGGC
TCTCGAAGGTCTCTTATGG -> CTCGAAGGTCTCTTATGGG
TGGCTAAATTAAGCTTTTC -> GGCTAAATTAAGCTTTTCA
AATTCACTTCACCAGCGAT -> ATTCACTTCACCAGCGATT
ATCTGCAGTAGTTCAGGCA -> TCTGCAGTAGTTCAGGCAA
GAATACTCAGTGGCAAAAT -> AATACTCAGTGGCAAAATG
GTCGTTGTTAGTTTATATT -> TCGTTGTTAGTTTATATTC
AACCCAACCGTCTTGGGTC -> ACCCAACCGTCTTGGGTCC
TTCCTTTGATAGCTAACAC -> TCCTTTGATAGCTAACACC
AGCCAAATTTTGTTGTGAT -> GCCAAATTTTGTTGTGATG
ATCACCCGTGTTGCGACGG -> TCACCCGTGTTGCGACGGA
GATAGACTTCGAATCTGCA -> ATAGACTTCGAATCTGCAG
CAGACTGATAGACTTCGAA -> AGACTGATAGACTTCGAAT
GGGTGCCTCGCTCAATCGG -> GGTGCCTCGCTCAATCGGA
ATCCATGGCGCTCTTTACC -> TCCATGGCGCTCTTTACCA
CTGGAGAAACTTGAGTTTA -> TGGAGAAACTTGAGTTTAT
GACCCGGCAGAGTTAGGGC -> ACCCGGCAGAGTTAGGGCA
GGGCCTCGGTTTGGGGCCA -> GGCCTCGGTTTGGGGCCAA
TAGGGAATTAACCCAACCG -> AGGGAATTAACCCAACCGT
CCCCGATGAGATCCGACCG -> CCCGATGAGATCCGACCGG
GAATTCCCAACACGCAGAG -> AATTCCCAACACGCAGAGG
CTGTGAACAAAGGTTCGCC -> TGTGAACAAAGGTTCGCCG
TCTACGGCAATACGCTATA -> CTACGGCAATACGCTATAT
CTATGGCCTTTTGATGTGA -> TATGGCCTTTTGATGTGAT
ATAGTCCGCTATTAAGTCC -> TAGTCCGCTATTAAGTCCG
AATGAATAACGGGTTCCGG -> ATGAATAACGGGTTCCGGA
GATATGTTGTAGAACAACG -> ATATGTTGTAGAACAACGA
CGAGGGGGAAGTCATGGTG -> GAGGGGGAAGTCATGGTGC
TGCAGTAGTTCAGGCAACC -> GCAGTAGTTCAGGCAACCC
CTCTCGGAACTTGTAGACC -> TCTCGGAACTTGTAGACCC
TATGAGCCTTGACTAAACG -> ATGAGCCTTGACTAAACGT
CATAACTATTCGTGTTAAT -> ATAACTATTCGTGTTAATC
TGCCTGTGCCTCTCTCAGG -> GCCTGTGCCTCTCTCAGGA
GGTTTCCGGCCCAGAACTC -> GTTTCCGGCCCAGAACTCA
CTAACGATGCGCTAAGCAA -> TAACGATGCGCTAAGCAAT
TAAATGGACAAGAATTCCC -> AAATGGACAAGAATTCCCA
TGATTAGCCTAAGAAATTC -> GATTAGCCTAAGAAATTCA
ACTTCGAATCTGCAGTAGT -> CTTCGAATCTGCAGTAGTT
TAAGATATCAGGGTTTTAC -> AAGATATCAGGGTTTTACC
ACGTGGACTGCGTCTCGAA -> CGTGGACTGCGTCTCGAAG
GTCAGGCCCCCGATGAGAT -> TCAGGCCCCCGATGAGATC
GTCAGCTTGGGGATGGAGC -> TCAGCTTGGGGATGGAGCG
CGTCTTGGGTCCTCAGTTA -> GTCTTGGGTCCTCAGTTAA
AACGGGTTCCGGAGAGCGA -> ACGGGTTCCGGAGAGCGAA
GCTTAAGACCGTCCTTCAA -> CTTAAGACCGTCCTTCAAT
AGTTCCGGTTATAAACCGC -> GTTCCGGTTATAAACCGCT
AGGCCTCTAACGCGTCTAT -> GGCCTCTAACGCGTCTATC
CGGTCAGGACCTTCGGCCA -> GGTCAGGACCTTCGGCCAT
GTCCGGAAGGCTGCGACAA -> TCCGGAAGGCTGCGACAAC
GAGACAGGGGGTGCCTCGC -> AGACAGGGGGTGCCTCGCT
ATGGCAACGTGATTAGCCT -> TGGCAACGTGATTAGCCTA
AACCGACCTTCGGCCATAG -> ACCGACCTTCGGCCATAGC
CTTCGGCCATAGCTATGGC -> TTCGGCCATAGCTATGGCA
GAACTCATCGCGTACCTTC -> AACTCATCGCGTACCTTCT
TTAAGGTCGTTCGACGAAG -> TAAGGTCGTTCGACGAAGG
TGACACGAGGGGGAAGTCA -> GACACGAGGGGGAAGTCAT
CGGCCATAGCTATGGCATG -> GGCCATAGCTATGGCATGT
TTGCTGACACCACCGATTA -> TGCTGACACCACCGATTAC
GCGGTGCGTTACGTCCTTC -> CGGTGCGTTACGTCCTTCA
AGGTTCGCCGGCGGCGCTA -> GGTTCGCCGGCGGCGCTAA
CAAAATGTAGGGAATTAAC -> AAAATGTAGGGAATTAACC
TCCGACCGGGGTCCGGAAG -> CCGACCGGGGTCCGGAAGG
GGGCCAAACGTCCCCGTGA -> GGCCAAACGTCCCCGTGAT
CGCTAAAGTCTTGTCCCAG -> GCTAAAGTCTTGTCCCAGT
GGGTCCTCAGTTAAGGTCG -> GGTCCTCAGTTAAGGTCGT
CGTGGACTGCGTCTCGAAG -> GTGGACTGCGTCTCGAAGG
CAAGATGGACCTTTGCTGA -> AAGATGGACCTTTGCTGAC
GTCATGGTGCCCTGTGAAC -> TCATGGTGCCCTGTGAACA
CAGAACTCATCGCGTACCT -> AGAACTCATCGCGTACCTT
TGGTCAACCGACCTTCGGC -> GGTCAACCGACCTTCGGCC
TAGGATAACTATTCAGAAT -> AGGATAACTATTCAGAATC
CGCATAAGATTTGGGACTT -> GCATAAGATTTGGGACTTC
GCATAGCTATTTGCTTGCC -> CATAGCTATTTGCTTGCCT
GCATGTTCAATAGAATCTC -> CATGTTCAATAGAATCTCT
AGCCTAAATGGACAAGAAT -> GCCTAAATGGACAAGAATT
TTGCCGTCCAGCTTCTAAA -> TGCCGTCCAGCTTCTAAAT
AACTTGTAGACCCGGCAGA -> ACTTGTAGACCCGGCAGAG
CTCAACCTGAACTAACGAT -> TCAACCTGAACTAACGATG
AAGCCAAGAATACTCAGTG -> AGCCAAGAATACTCAGTGG
AGGGAATTAACCCAACCGT -> GGGAATTAACCCAACCGTC
AAATCGGATGTCTGTCAGC -> AATCGGATGTCTGTCAGCT
CCATAGCTATAGGTCTGAT -> CATAGCTATAGGTCTGATG
ATAAATCGGATGTCTGTCA -> TAAATCGGATGTCTGTCAG
TTGCGACGGAACTATAGTC -> TGCGACGGAACTATAGTCC
GCCTTGACTAAACGTGAGC -> CCTTGACTAAACGTGAGCA
CTCTTTACCATAAATCGGA -> TCTTTACCATAAATCGGAT
CTCTGGAGAAACTTGAGTT -> TCTGGAGAAACTTGAGTTT
CAATAACTAAGTTTGGACC -> AATAACTAAGTTTGGACCT
ATTAGCCTAAGAAATTCAC -> TTAGCCTAAGAAATTCACT
GATCCGACCGGGGTCCGGA -> ATCCGACCGGGGTCCGGAA
TATGGGGCCTCGGTTTGGG -> ATGGGGCCTCGGTTTGGGG
CCACGCGTTTGATGCGGGA -> CACGCGTTTGATGCGGGAC
GATGTCTGTCAGCTTGGGG -> ATGTCTGTCAGCTTGGGGA
TAGTCCGCTATTAAGTCCG -> AGTCCGCTATTAAGTCCGT
CAGAATCATAACTATTCGT -> AGAATCATAACTATTCGTG
GTTACGTCCTTCACCCGGC -> TTACGTCCTTCACCCGGCG
ATGCGTATTCGCCCAACCT -> TGCGTATTCGCCCAACCTG
GCTATGGATGACACGAGGG -> CTATGGATGACACGAGGGG
TCATAACTATTCGTGTTAA -> CATAACTATTCGTGTTAAT
GATGAGATCCGACCGGGGT -> ATGAGATCCGACCGGGGTC
GACAAGGTTGGCTGCGAAA -> ACAAGGTTGGCTGCGAAAG
TAAGTCCGTGAAGGACTTT -> AAGTCCGTGAAGGACTTTA
ACACCGTCAACGTGATTCC -> CACCGTCAACGTGATTCCT
TTGCTACAATCACCCGTGT -> TGCTACAATCACCCGTGTT
CATCGAGGACAAGGTTGGC -> ATCGAGGACAAGGTTGGCT
CAAGAATTCCCAACACGCA -> AAGAATTCCCAACACGCAG
AGTGTCAGGCCCCCGATGA -> GTGTCAGGCCCCCGATGAG
GTTTATATTCAGGAAACGA -> TTTATATTCAGGAAACGAT
TCGAGGACAAGGTTGGCTG -> CGAGGACAAGGTTGGCTGC
GGGGAAGTCATGGTGCCCT -> GGGAAGTCATGGTGCCCTG
GGAAGCTAGTTAGCGGCCG -> GAAGCTAGTTAGCGGCCGG
ATAACTATTCAGAATCATA -> TAACTATTCAGAATCATAA
TGGCTGCGAAAGCTTCGGC -> GGCTGCGAAAGCTTCGGCT
GATGGAGCGTGAAGTAATG -> ATGGAGCGTGAAGTAATGG
ACTTCTGTGGCGACGGTGG -> CTTCTGTGGCGACGGTGGA
CTTAATTACTACGAGACCC -> TTAATTACTACGAGACCCA
TATTCGTGTTAATCGTAGG -> ATTCGTGTTAATCGTAGGC
GGTGCCCACCGCTTGTAAC -> GTGCCCACCGCTTGTAACT
TGTCGTCTCGGTAAGATAT -> GTCGTCTCGGTAAGATATC
TAGACCCGGCAGAGTTAGG -> AGACCCGGCAGAGTTAGGG
TTCGGCTTAAGACCGTCCT -> TCGGCTTAAGACCGTCCTT
TTCGGCCATAGCTATCCCT -> TCGGCCATAGCTATCCCTA
GTCTCGAAGGTCTCTTATG -> TCTCGAAGGTCTCTTATGG
GCGATCAACACCCACGCGT -> CGATCAACACCCACGCGTT
CTAAATGGACAAGAATTCC -> TAAATGGACAAGAATTCCC
AATGCGATCAACACCCACG -> ATGCGATCAACACCCACGC
AAGGTCTCTTATGGGGCCT -> AGGTCTCTTATGGGGCCTC
GACATCAGGCGATATGCAG -> ACATCAGGCGATATGCAGT
TTGGGGATGGAGCGTGAAG -> TGGGGATGGAGCGTGAAGT
TCAATGGCATCGAGGACAA -> CAATGGCATCGAGGACAAG
CCTTTTGATGTGATCAGAA -> CTTTTGATGTGATCAGAAC
AACCCTGACTGCGCCTCTT -> ACCCTGACTGCGCCTCTTT
AACTGGATGACCTTCGGCC -> ACTGGATGACCTTCGGCCA
AATGTCTGGTTTCCGGCCC -> ATGTCTGGTTTCCGGCCCA
TCGAAGGTCTCTTATGGGG -> CGAAGGTCTCTTATGGGGC
TCAGGGTTTTACCCGGCCG -> CAGGGTTTTACCCGGCCGT
TTGTTCACGATCTCTTAAT -> TGTTCACGATCTCTTAATT
CTAAGAAATTCACTTCACC -> TAAGAAATTCACTTCACCA
TCACGATCTCTTAATTACT -> CACGATCTCTTAATTACTA
ATGCAGTTCCTCTACGGCA -> TGCAGTTCCTCTACGGCAA
ACCTTGCATAGCTATTTGC -> CCTTGCATAGCTATTTGCT
GCGTATTCGCCCAACCTGT -> CGTATTCGCCCAACCTGTA
CCGTCGTCTGTCGAACGAT -> CGTCGTCTGTCGAACGATG
GATGATAAAAATTGAAATG -> ATGATAAAAATTGAAATGA
GCTATGGCATGTTCAATAG -> CTATGGCATGTTCAATAGA
GCAACCCTGACTGCGCCTC -> CAACCCTGACTGCGCCTCT
TAGTTCAGGCAACCCTGAC -> AGTTCAGGCAACCCTGACT
CGTCCAATGGAAGACGGGG -> GTCCAATGGAAGACGGGGG
CGTGGCTAAATTAAGCTTT -> GTGGCTAAATTAAGCTTTT
ATAGCTATGGCATGTTCAA -> TAGCTATGGCATGTTCAAT
GGATTGCCGTCCAGCTTCT -> GATTGCCGTCCAGCTTCTA
TCGCCCAACCTGTAGGCCT -> CGCCCAACCTGTAGGCCTC
TCGGCCATAGCTATCCCTA -> CGGCCATAGCTATCCCTAT
ACGAACCAGAGCGAAGCCA -> CGAACCAGAGCGAAGCCAG
TCTCAATGGCATCGAGGAC -> CTCAATGGCATCGAGGACA
TTCTGACTCTCGGAACTTG -> TCTGACTCTCGGAACTTGT
GGGCACGAGAGACAGGGGG -> GGCACGAGAGACAGGGGGT
TGATGCGGGACATCAGGCG -> GATGCGGGACATCAGGCGA
AGAATACTCAGTGGCAAAA -> GAATACTCAGTGGCAAAAT
CAAGGGCTATCCATGGCGC -> AAGGGCTATCCATGGCGCT
TGACAACTGGATGACCTTC -> GACAACTGGATGACCTTCG
CCGCAACCATCGCGAGCTG -> CGCAACCATCGCGAGCTGC
TGAGTTTATGAGCCTTGAC -> GAGTTTATGAGCCTTGACT
CTTTATCCATGCAGTTCCT -> TTTATCCATGCAGTTCCTC
AGATTTGGGACTTCTGTGG -> GATTTGGGACTTCTGTGGC
CAAGAATACTCAGTGGCAA -> AAGAATACTCAGTGGCAAA
GACAGGGGGTGCCTCGCTC -> ACAGGGGGTGCCTCGCTCA
TGGACCTTTGCTGACACCA -> GGACCTTTGCTGACACCAC
AAGAATTCCCAACACGCAG -> AGAATTCCCAACACGCAGA
CCTTGACTAAACGTGAGCA -> CTTGACTAAACGTGAGCAA
CCGCAAGATGGACCTTTGC -> CGCAAGATGGACCTTTGCT
GGTCATGTACACTAAGTGC -> GTCATGTACACTAAGTGCA
GTTCCGGTTATAAACCGCT -> TTCCGGTTATAAACCGCTA
TCCGTGAAGGACTTTAGTT -> CCGTGAAGGACTTTAGTTC
GCGTTCATGTAACCTGTCA -> CGTTCATGTAACCTGTCAG
ACATGCTTCGGATGATAAA -> CATGCTTCGGATGATAAAA
TCAGGCCCCCGATGAGATC -> CAGGCCCCCGATGAGATCC
GCTACATTGTGTCGTCTCG -> CTACATTGTGTCGTCTCGG
CGACGGTGGAAGCTAGTTA -> GACGGTGGAAGCTAGTTAG
ATGACCTTCGGCCATAGCT -> TGACCTTCGGCCATAGCTA
GTTTATGAGCCTTGACTAA -> TTTATGAGCCTTGACTAAA
TTTGTTGTGATGCGTATTC -> TTGTTGTGATGCGTATTCG
AGTGCACCGACATGCGCGT -> GTGCACCGACATGCGCGTT
TTCCGTAAGGAGCTATGGC -> TCCGTAAGGAGCTATGGCC
GTAGACCCGGCAGAGTTAG -> TAGACCCGGCAGAGTTAGG
AAGGAGCTATGGCCTTTTG -> AGGAGCTATGGCCTTTTGA
GCCATAGCTATTTTCAGCT -> CCATAGCTATTTTCAGCTT
TGCGTTACGTCCTTCACCC -> GCGTTACGTCCTTCACCCG
TATAGCATAGCCTAAATGG -> ATAGCATAGCCTAAATGGA
CGGATGATAAAAATTGAAA -> GGATGATAAAAATTGAAAT
AGTGCTGCAGGGCTACATG -> GTGCTGCAGGGCTACATGA
TACACGATCTACTTTGCTC -> ACACGATCTACTTTGCTCG
GGTTAATGCGATCAACACC -> GTTAATGCGATCAACACCC
AGGCGATATGCAGTACACG -> GGCGATATGCAGTACACGA
AACGCGTCTATCACGGGGT -> ACGCGTCTATCACGGGGTC
TAGCCTAAGAAATTCACTT -> AGCCTAAGAAATTCACTTC
AGCGGTGCGTTACGTCCTT -> GCGGTGCGTTACGTCCTTC
GTTGGCTGCGAAAGCTTCG -> TTGGCTGCGAAAGCTTCGG
CTTGGGTCCTCAGTTAAGG -> TTGGGTCCTCAGTTAAGGT
GACACCACCGATTACACAT -> ACACCACCGATTACACATG
GCAACGTGATTAGCCTAAG -> CAACGTGATTAGCCTAAGA
GTCTGATGTCATTGAGGGC -> TCTGATGTCATTGAGGGCA
TATGGCCTTTTGATGTGAT -> ATGGCCTTTTGATGTGATC
ATTCCTTTGATAGCTAACA -> TTCCTTTGATAGCTAACAC
CCCGTGTTGCGACGGAACT -> CCGTGTTGCGACGGAACTA
ATAGTAGGATAACTATTCA -> TAGTAGGATAACTATTCAG
AACCTTATGACAAAGGCGT -> ACCTTATGACAAAGGCGTT
TAGTTTATATTCAGGAAAC -> AGTTTATATTCAGGAAACG
TGCAGTACACGATCTACTT -> GCAGTACACGATCTACTTT
AGTCCGGGTTAATGCGATC -> GTCCGGGTTAATGCGATCA
TCGGTTTGGGGCCAAACGT -> CGGTTTGGGGCCAAACGTC
TCTCGGTAAGATATCAGGG -> CTCGGTAAGATATCAGGGT
GGACCTTATTTCTCTTGCT -> GACCTTATTTCTCTTGCTA
GCCCAACCTGTAGGCCTCT -> CCCAACCTGTAGGCCTCTA
TGAGTCACATGCTTCGGAT -> GAGTCACATGCTTCGGATG
ATGCGCTAAGCAATCATGG -> TGCGCTAAGCAATCATGGT
ATCGCGAGCTGCCTGTGCC -> TCGCGAGCTGCCTGTGCCT
TTCGTGTTAATCGTAGGCG -> TCGTGTTAATCGTAGGCGG
AGGTCGCCTACGGCCAGGC -> GGTCGCCTACGGCCAGGCA
TCAGAACGGTCACCGCAAG -> CAGAACGGTCACCGCAAGA
GCTAGTTAGCGGCCGGAAG -> CTAGTTAGCGGCCGGAAGC
TGTTCAATAGAATCTCTAT -> GTTCAATAGAATCTCTATG
TTTATGAGCCTTGACTAAA -> TTATGAGCCTTGACTAAAC
GGTTGGCTGCGAAAGCTTC -> GTTGGCTGCGAAAGCTTCG
CTCTCTCAGGATCGGCAGC -> TCTCTCAGGATCGGCAGCT
CTAGTTCCGGTTATAAACC -> TAGTTCCGGTTATAAACCG
GCTGCAGGGCTACATGACC -> CTGCAGGGCTACATGACCT
ACAAGGTTGGCTGCGAAAG -> CAAGGTTGGCTGCGAAAGC
ACACGCAGAGGTCGCCTAC -> CACGCAGAGGTCGCCTACG
TCAGAACTCAGCCGCCAGC -> CAGAACTCAGCCGCCAGCT
CATAGCTATTTTCAGCTTA -> ATAGCTATTTTCAGCTTAA
GAATTAACCCAACCGTCTT -> AATTAACCCAACCGTCTTG
CGTTCATGTAACCTGTCAG -> GTTCATGTAACCTGTCAGA
CAGAGGTCGCCTACGGCCA -> AGAGGTCGCCTACGGCCAG
GTGAAGGACTTTAGTTCTG -> TGAAGGACTTTAGTTCTGA
GTTTGGGGCCAAACGTCCC -> TTTGGGGCCAAACGTCCCC
GCTGCGAAAGCTTCGGCTT -> CTGCGAAAGCTTCGGCTTA
GCTCGCATAAGATTTGGGA -> CTCGCATAAGATTTGGGAC
ACCGCTTGTAACTCTGTCG -> CCGCTTGTAACTCTGTCGT
TGTAGGGAATTAACCCAAC -> GTAGGGAATTAACCCAACC
CTACGGCCAGGCAGCGGTG -> TACGGCCAGGCAGCGGTGC
CGCGTTTGATGCGGGACAT -> GCGTTTGATGCGGGACATC
CAGAGTTAGGGCACGAGAG -> AGAGTTAGGGCACGAGAGA
GAGACCCAATTGGAAGGTT -> AGACCCAATTGGAAGGTTT
TTCCGGTTATAAACCGCTA -> TCCGGTTATAAACCGCTAT
AATAACTAAGTTTGGACCT -> ATAACTAAGTTTGGACCTT
CTTGGGGATGGAGCGTGAA -> TTGGGGATGGAGCGTGAAG
GTTTCCGGCCCAGAACTCA -> TTTCCGGCCCAGAACTCAT
GGCCCCCGATGAGATCCGA -> GCCCCCGATGAGATCCGAC
AATCACCCGTGTTGCGACG -> ATCACCCGTGTTGCGACGG
CCTTCACCCGGCGGGTAAT -> CTTCACCCGGCGGGTAATC
TGGGGATGGAGCGTGAAGT -> GGGGATGGAGCGTGAAGTA
TTACGTCCTTCACCCGGCG -> TACGTCCTTCACCCGGCGG
GGACTTTAGTTCTGACTCT -> GACTTTAGTTCTGACTCTC
GCCATAGCTATCCCTATAG -> CCATAGCTATCCCTATAGC
GCAGAGGTCGCCTACGGCC -> CAGAGGTCGCCTACGGCCA
TCGGTAAGATATCAGGGTT -> CGGTAAGATATCAGGGTTT
GAGGGGGAAGTCATGGTGC -> AGGGGGAAGTCATGGTGCC
TGGCCTTTTGATGTGATCA -> GGCCTTTTGATGTGATCAG
GGTGCGTTACGTCCTTCAC -> GTGCGTTACGTCCTTCACC
CCTGTATTCCGTAAGGAGC -> CTGTATTCCGTAAGGAGCT
TAATGCGATCAACACCCAC -> AATGCGATCAACACCCACG
AAGCAATGACAACTGGATG -> AGCAATGACAACTGGATGA
ACACGATCTACTTTGCTCG -> CACGATCTACTTTGCTCGC
CTTGAGTTTATGAGCCTTG -> TTGAGTTTATGAGCCTTGA
TACCTCGACTGGATAGTAG -> ACCTCGACTGGATAGTAGG
AGCTTGGGGATGGAGCGTG -> GCTTGGGGATGGAGCGTGA
TTAGGGCACGAGAGACAGG -> TAGGGCACGAGAGACAGGG
GCACCGACATGCGCGTTCA -> CACCGACATGCGCGTTCAT
TGGATTGCCGTCCAGCTTC -> GGATTGCCGTCCAGCTTCT
GCCAGGCAGCGGTGCGTTA -> CCAGGCAGCGGTGCGTTAC
TTCGGCCATAGCTATAGGT -> TCGGCCATAGCTATAGGTC
TCCCAACACGCAGAGGTCG -> CCCAACACGCAGAGGTCGC
ATCAGAACTCAGCCGCCAG -> TCAGAACTCAGCCGCCAGC
GGGGCCTCGGTTTGGGGCC -> GGGCCTCGGTTTGGGGCCA
TCGTCTGTCGAACGATGCG -> CGTCTGTCGAACGATGCGC
CAAAATGAGTCACATGCTT -> AAAATGAGTCACATGCTTC
CGGTAAGATATCAGGGTTT -> GGTAAGATATCAGGGTTTT
AGCTATGGCCTTTTGATGT -> GCTATGGCCTTTTGATGTG
TGCGAAAGCTTCGGCTTAA -> GCGAAAGCTTCGGCTTAAG
TAAACGTACACTCTCAATG -> AAACGTACACTCTCAATGG
TGTTAATCGTAGGCGGCAA -> GTTAATCGTAGGCGGCAAC
AGTTAAGGTCGTTCGACGA -> GTTAAGGTCGTTCGACGAA
ACATCAGGCGATATGCAGT -> CATCAGGCGATATGCAGTA
ATTACACATGATTTTACCG -> TTACACATGATTTTACCGT
GAAGCCAGACTGATAGACT -> AAGCCAGACTGATAGACTT
AGCCTTGACTAAACGTGAG -> GCCTTGACTAAACGTGAGC
TAAGCTTTTCAAAATGTAG -> AAGCTTTTCAAAATGTAGG
AAAGGCGTTTATGCATTCG -> AAGGCGTTTATGCATTCGC
CTAAATGTCTGGTTTCCGG -> TAAATGTCTGGTTTCCGGC
AGCTGACGCTCTGGAGAAA -> GCTGACGCTCTGGAGAAAC
TGTAGACCCGGCAGAGTTA -> GTAGACCCGGCAGAGTTAG
CTTTGAGTGCCTAGTTCCG -> TTTGAGTGCCTAGTTCCGG
ACCTTCTGCGATTACCTCG -> CCTTCTGCGATTACCTCGA
CCTAAATGGACAAGAATTC -> CTAAATGGACAAGAATTCC
CCCGGCGGGTAATCTAAAC -> CCGGCGGGTAATCTAAACC
AGCCAGACTGATAGACTTC -> GCCAGACTGATAGACTTCG
CGGTGCGTTACGTCCTTCA -> GGTGCGTTACGTCCTTCAC
CCAGACTGATAGACTTCGA -> CAGACTGATAGACTTCGAA
CATCGCGTACCTTCTGCGA -> ATCGCGTACCTTCTGCGAT
TTTGGGACTTCTGTGGCGA -> TTGGGACTTCTGTGGCGAC
CTATGGCATGTTCAATAGA -> TATGGCATGTTCAATAGAA
TGGGTCCTCAGTTAAGGTC -> GGGTCCTCAGTTAAGGTCG
AAGCTTCGGCTTAAGACCG -> AGCTTCGGCTTAAGACCGT
GTACACTAAGTGCACCGAC -> TACACTAAGTGCACCGACA
GCCTGTATTCCGTAAGGAG -> CCTGTATTCCGTAAGGAGC
TGGCGACGGTGGAAGCTAG -> GGCGACGGTGGAAGCTAGT
AGTACACGATCTACTTTGC -> GTACACGATCTACTTTGCT
CGAACAGTACGAACCAGAG -> GAACAGTACGAACCAGAGC
GTCTTGTCCCAGTCCGGGT -> TCTTGTCCCAGTCCGGGTT
GGACTGCGTCTCGAAGGTC -> GACTGCGTCTCGAAGGTCT
AAGTAATGGGTGTAGAACT -> AGTAATGGGTGTAGAACTC
AGGCAGCGGTGCGTTACGT -> GGCAGCGGTGCGTTACGTC
GGTCTCTTATGGGGCCTCG -> GTCTCTTATGGGGCCTCGG
GCAAGGGCTATCCATGGCG -> CAAGGGCTATCCATGGCGC
CTGTCAGCTTGGGGATGGA -> TGTCAGCTTGGGGATGGAG
CGCGTCGAAGGTATTAGGA -> GCGTCGAAGGTATTAGGAC
TTGCTTGCCTGTATTCCGT -> TGCTTGCCTGTATTCCGTA
TGTAGAACAACGATGCGCT -> GTAGAACAACGATGCGCTA
CTAAGTGCACCGACATGCG -> TAAGTGCACCGACATGCGC
TTGATGTGATCAGAACTCA -> TGATGTGATCAGAACTCAG
AAGCTGGATTGCCGTCCAG -> AGCTGGATTGCCGTCCAGC
AGAGACAGGGGGTGCCTCG -> GAGACAGGGGGTGCCTCGC
GGATAACTATTCAGAATCA -> GATAACTATTCAGAATCAT
TGTTGCGACGGAACTATAG -> GTTGCGACGGAACTATAGT
AATCGGACCCGGGGGTGCC -> ATCGGACCCGGGGGTGCCC
TGCGCCTCTTTGAGTGCCT -> GCGCCTCTTTGAGTGCCTA
AAGGACTTTAGTTCTGACT -> AGGACTTTAGTTCTGACTC
AATCTCTATGGCAACGTGA -> ATCTCTATGGCAACGTGAT
GGACTTCTGTGGCGACGGT -> GACTTCTGTGGCGACGGTG
AACCGTCTTGGGTCCTCAG -> ACCGTCTTGGGTCCTCAGT
GATGTCATTGAGGGCAAGG -> ATGTCATTGAGGGCAAGGG
CTATGGCAACGTGATTAGC -> TATGGCAACGTGATTAGCC
TTCAAAATGTAGGGAATTA -> TCAAAATGTAGGGAATTAA
TGCGTCTCGAAGGTCTCTT -> GCGTCTCGAAGGTCTCTTA
CTATAGGTCTGATGTCATT -> TATAGGTCTGATGTCATTG
GGAGAAACTTGAGTTTATG -> GAGAAACTTGAGTTTATGA
CCAGCTTCTAAATGTCTGG -> CAGCTTCTAAATGTCTGGT
GCGTTACGTCCTTCACCCG -> CGTTACGTCCTTCACCCGG
CTCAATCGGACCCGGGGGT -> TCAATCGGACCCGGGGGTG
CACGGGGTCGTTGTTAGTT -> ACGGGGTCGTTGTTAGTTT
GTCCTCAGTTAAGGTCGTT -> TCCTCAGTTAAGGTCGTTC
ACTGCGTCTCGAAGGTCTC -> CTGCGTCTCGAAGGTCTCT
AGGCGGTCAGGACCTTCGG -> GGCGGTCAGGACCTTCGGC
CTCTTGCTACAATCACCCG -> TCTTGCTACAATCACCCGT
CAGCTCCCAACGTTTGTTC -> AGCTCCCAACGTTTGTTCA
TTCCTCTACGGCAATACGC -> TCCTCTACGGCAATACGCT
CTTGCTACAATCACCCGTG -> TTGCTACAATCACCCGTGT
ACATTGTGTCGTCTCGGTA -> CATTGTGTCGTCTCGGTAA
GTCCTTCACCCGGCGGGTA -> TCCTTCACCCGGCGGGTAA
ACCTGTCAGAACGGTCACC -> CCTGTCAGAACGGTCACCG
AGGATCGGCAGCTCCCAAC -> GGATCGGCAGCTCCCAACG
AAATTGAAATGAATAACGG -> AATTGAAATGAATAACGGG
CGATGCGCTAAGCAATCAT -> GATGCGCTAAGCAATCATG
TCTGACTCTCGGAACTTGT -> CTGACTCTCGGAACTTGTA
GACTGATAGACTTCGAATC -> ACTGATAGACTTCGAATCT
CCGTGAAGGACTTTAGTTC -> CGTGAAGGACTTTAGTTCT
CTCTCAGGATCGGCAGCTC -> TCTCAGGATCGGCAGCTCC
GGCAACCCTGACTGCGCCT -> GCAACCCTGACTGCGCCTC
CAGCTGACGTGGACTGCGT -> AGCTGACGTGGACTGCGTC
GGCGGGTAATCTAAACCCG -> GCGGGTAATCTAAACCCGG
CAATCATGGTCAACCGACC -> AATCATGGTCAACCGACCT
GCAATGACAACTGGATGAC -> CAATGACAACTGGATGACC
CAACCATCGCGAGCTGCCT -> AACCATCGCGAGCTGCCTG
TGCGTATTCGCCCAACCTG -> GCGTATTCGCCCAACCTGT
CTATTTGCTTGCCTGTATT -> TATTTGCTTGCCTGTATTC
ACTAAGTGCACCGACATGC -> CTAAGTGCACCGACATGCG
AGTAGGATAACTATTCAGA -> GTAGGATAACTATTCAGAA
GCCCACCGCTTGTAACTCT -> CCCACCGCTTGTAACTCTG
TAGTTCCGGTTATAAACCG -> AGTTCCGGTTATAAACCGC
CTTTAGTTCTGACTCTCGG -> TTTAGTTCTGACTCTCGGA
TCTACTTTGCTCGCATAAG -> CTACTTTGCTCGCATAAGA
CAATCACCCGTGTTGCGAC -> AATCACCCGTGTTGCGACG
CGTCAACGTGATTCCTTTG -> GTCAACGTGATTCCTTTGA
CAGCTTGGGGATGGAGCGT -> AGCTTGGGGATGGAGCGTG
GAAGTCATGGTGCCCTGTG -> AAGTCATGGTGCCCTGTGA
CATGATTTTACCGTCCAAT -> ATGATTTTACCGTCCAATG
GCCGTCCAGCTTCTAAATG -> CCGTCCAGCTTCTAAATGT
TACTACGAGACCCAATTGG -> ACTACGAGACCCAATTGGA
CGTCTCGGTAAGATATCAG -> GTCTCGGTAAGATATCAGG
AAAAATTGAAATGAATAAC -> AAAATTGAAATGAATAACG
TTAAGACCGTCCTTCAATC -> TAAGACCGTCCTTCAATCG
TGCGGGACATCAGGCGATA -> GCGGGACATCAGGCGATAT
GCGCCTCTTTGAGTGCCTA -> CGCCTCTTTGAGTGCCTAG
CATGCTTCGGATGATAAAA -> ATGCTTCGGATGATAAAAA
ATTGGTCATGTACACTAAG -> TTGGTCATGTACACTAAGT
CCACCGCTTGTAACTCTGT -> CACCGCTTGTAACTCTGTC
GCTGACGCTCTGGAGAAAC -> CTGACGCTCTGGAGAAACT
AACTAAGTTTGGACCTTCG -> ACTAAGTTTGGACCTTCGG
CAATCGAGCTGACGCTCTG -> AATCGAGCTGACGCTCTGG
ATGCGCGTTCATGTAACCT -> TGCGCGTTCATGTAACCTG
TGAATAACGGGTTCCGGAG -> GAATAACGGGTTCCGGAGA
CTGCGAAAGCTTCGGCTTA -> TGCGAAAGCTTCGGCTTAA
TAGGCGGCAACGTGGCTAA -> AGGCGGCAACGTGGCTAAA
CCTTATTTCTCTTGCTACA -> CTTATTTCTCTTGCTACAA
GGGGTGCCTCGCTCAATCG -> GGGTGCCTCGCTCAATCGG
ACCCACGCGTTTGATGCGG -> CCCACGCGTTTGATGCGGG
AAATGAATAACGGGTTCCG -> AATGAATAACGGGTTCCGG
TCGAGCTGACGCTCTGGAG -> CGAGCTGACGCTCTGGAGA
ATTCGCGTCGAAGGTATTA -> TTCGCGTCGAAGGTATTAG
ACCCGGCAGAGTTAGGGCA -> CCCGGCAGAGTTAGGGCAC
TGTGAACAAAGGTTCGCCG -> GTGAACAAAGGTTCGCCGG
TTCCCAACACGCAGAGGTC -> TCCCAACACGCAGAGGTCG
AACTCTGTCGTCGTCAATA -> ACTCTGTCGTCGTCAATAG
CGGGACATCAGGCGATATG -> GGGACATCAGGCGATATGC
ATGCTTCGGATGATAAAAA -> TGCTTCGGATGATAAAAAT
TAGTAGGATAACTATTCAG -> AGTAGGATAACTATTCAGA
ATGTGATCAGAACTCAGCC -> TGTGATCAGAACTCAGCCG
ATAGCCTAAATGGACAAGA -> TAGCCTAAATGGACAAGAA
CAAAGGTTCGCCGGCGGCG -> AAAGGTTCGCCGGCGGCGC
GTTCATGTAACCTGTCAGA -> TTCATGTAACCTGTCAGAA
CCATCGCGAGCTGCCTGTG -> CATCGCGAGCTGCCTGTGC
CGTGATTCCTTTGATAGCT -> GTGATTCCTTTGATAGCTA
GCCCTGTGAACAAAGGTTC -> CCCTGTGAACAAAGGTTCG
TGAACTAACGATGCGCTAA -> GAACTAACGATGCGCTAAG
GCGCTAAGCAATGACAACT -> CGCTAAGCAATGACAACTG
TAAGCAATTAGGCGGTCAG -> AAGCAATTAGGCGGTCAGG
CGGGTAATCTAAACCCGGA -> GGGTAATCTAAACCCGGAT
ACGAAGGAAAAGCCAAGAA -> CGAAGGAAAAGCCAAGAAT
CTTATGGGGCCTCGGTTTG -> TTATGGGGCCTCGGTTTGG
ACGATGCGCTAAGCAATTA -> CGATGCGCTAAGCAATTAG
GTTAGGGCACGAGAGACAG -> TTAGGGCACGAGAGACAGG
ATTCCGTCGTCTGTCGAAC -> TTCCGTCGTCTGTCGAACG
CTCGGTAAGATATCAGGGT -> TCGGTAAGATATCAGGGTT
GATCCTGGCTACATTGTGT -> ATCCTGGCTACATTGTGTC
TAGAACTCGTGGGAATAAA -> AGAACTCGTGGGAATAAAA
TGACTGCGCCTCTTTGAGT -> GACTGCGCCTCTTTGAGTG
GGGACATCAGGCGATATGC -> GGACATCAGGCGATATGCA
TATCGACACACCGTCAACG -> ATCGACACACCGTCAACGT
GCTATATATCGACACACCG -> CTATATATCGACACACCGT
CGGCCCAGAACTCATCGCG -> GGCCCAGAACTCATCGCGT
CCGTGTTGCGACGGAACTA -> CGTGTTGCGACGGAACTAT
CCCGGCCGTATTCCGTCAG -> CCGGCCGTATTCCGTCAGT
CAACCTGAACTAACGATGC -> AACCTGAACTAACGATGCG
AAGGAAAAGCCAAGAATAC -> AGGAAAAGCCAAGAATACT
GCTTCTAAATGTCTGGTTT -> CTTCTAAATGTCTGGTTTC
TGACTAAACGTGAGCAAGC -> GACTAAACGTGAGCAAGCA
GTAGGCGGCAACGTGGCTA -> TAGGCGGCAACGTGGCTAA
ATTCACTTCACCAGCGATT -> TTCACTTCACCAGCGATTG
GCCCAGAACTCATCGCGTA -> CCCAGAACTCATCGCGTAC
AGCTGACGTGGACTGCGTC -> GCTGACGTGGACTGCGTCT
TGCTGCAGGGCTACATGAC -> GCTGCAGGGCTACATGACC
TGAGCAAGCAGACTTTATC -> GAGCAAGCAGACTTTATCC
TCCTTTGATAGCTAACACC -> CCTTTGATAGCTAACACCT
TATTCGCCCAACCTGTAGG -> ATTCGCCCAACCTGTAGGC
AACACCCACGCGTTTGATG -> ACACCCACGCGTTTGATGC
ATATATCGACACACCGTCA -> TATATCGACACACCGTCAA
GGCCATAGCTATGGCATGT -> GCCATAGCTATGGCATGTT
CAGGAAACGATGCGCTAAG -> AGGAAACGATGCGCTAAGC
CCGCCAGCTGACGTGGACT -> CGCCAGCTGACGTGGACTG
GCTTGCCTGTATTCCGTAA -> CTTGCCTGTATTCCGTAAG
ACTCATCGCGTACCTTCTG -> CTCATCGCGTACCTTCTGC
CACGAGGGGGAAGTCATGG -> ACGAGGGGGAAGTCATGGT
GGTTATAAACCGCTATGGA -> GTTATAAACCGCTATGGAT
TCGTCGTCAATAGTGCTGC -> CGTCGTCAATAGTGCTGCA
AACGTGGCTAAATTAAGCT -> ACGTGGCTAAATTAAGCTT
TCCGTAAGGAGCTATGGCC -> CCGTAAGGAGCTATGGCCT
ACCCAATTGGAAGGTTTCC -> CCCAATTGGAAGGTTTCCT
TAGCTATCCCTATAGCATA -> AGCTATCCCTATAGCATAG
CTCCCAACGTTTGTTCACG -> TCCCAACGTTTGTTCACGA
TTCACTTCACCAGCGATTG -> TCACTTCACCAGCGATTGG
CCTTCGGCCATAGCTATCC -> CTTCGGCCATAGCTATCCC
TCAGTGTCAGGCCCCCGAT -> CAGTGTCAGGCCCCCGATG
AATCATGGTCAACCGACCT -> ATCATGGTCAACCGACCTT
AGGACCTTCGGCCATAGCT -> GGACCTTCGGCCATAGCTA
GATGGACCTTTGCTGACAC -> ATGGACCTTTGCTGACACC
ACTTGAGTTTATGAGCCTT -> CTTGAGTTTATGAGCCTTG
CCTGTCAGAACGGTCACCG -> CTGTCAGAACGGTCACCGC
ACCGCAAGATGGACCTTTG -> CCGCAAGATGGACCTTTGC
ATTGAGGGCAAGGGCTATC -> TTGAGGGCAAGGGCTATCC
AAATGTCTGGTTTCCGGCC -> AATGTCTGGTTTCCGGCCC
CTAAGTTTGGACCTTCGGC -> TAAGTTTGGACCTTCGGCC
GTAGAACTCGTGGGAATAA -> TAGAACTCGTGGGAATAAA
GCTATGGCCTTTTGATGTG -> CTATGGCCTTTTGATGTGA
GGCTAAATTAAGCTTTTCA -> GCTAAATTAAGCTTTTCAA
CGACCGGGGTCCGGAAGGC -> GACCGGGGTCCGGAAGGCT
CTTTGATAGCTAACACCTC -> TTTGATAGCTAACACCTCC
GCAACGTGGCTAAATTAAG -> CAACGTGGCTAAATTAAGC
CCCAGTCCGGGTTAATGCG -> CCAGTCCGGGTTAATGCGA
ATTACTACGAGACCCAATT -> TTACTACGAGACCCAATTG
CCTTTGCTGACACCACCGA -> CTTTGCTGACACCACCGAT
TAGGACCTTATTTCTCTTG -> AGGACCTTATTTCTCTTGC
AGCGGCCGGAAGCCAAATT -> GCGGCCGGAAGCCAAATTT
TCGTCAATAGTGCTGCAGG -> CGTCAATAGTGCTGCAGGG
GGAAGGTTTCCTAACCTTA -> GAAGGTTTCCTAACCTTAT
GAGCGAAGCCAGACTGATA -> AGCGAAGCCAGACTGATAG
GTGCCTAGTTCCGGTTATA -> TGCCTAGTTCCGGTTATAA
AACCAGAGCGAAGCCAGAC -> ACCAGAGCGAAGCCAGACT
AGGTCTCTTATGGGGCCTC -> GGTCTCTTATGGGGCCTCG
AGCAATCATGGTCAACCGA -> GCAATCATGGTCAACCGAC
CGAATCTGCAGTAGTTCAG -> GAATCTGCAGTAGTTCAGG
AATGGCATCGAGGACAAGG -> ATGGCATCGAGGACAAGGT
GTGTCTCAACCTGAACTAA -> TGTCTCAACCTGAACTAAC
GCACGAGAGACAGGGGGTG -> CACGAGAGACAGGGGGTGC
AGAAATTCACTTCACCAGC -> GAAATTCACTTCACCAGCG
CGGCGGGTAATCTAAACCC -> GGCGGGTAATCTAAACCCG
TCGCTCAATCGGACCCGGG -> CGCTCAATCGGACCCGGGG
CTCAGTTAAGGTCGTTCGA -> TCAGTTAAGGTCGTTCGAC
CTTCACCCGGCGGGTAATC -> TTCACCCGGCGGGTAATCT
GCTAAGCAATTAGGCGGTC -> CTAAGCAATTAGGCGGTCA
GCCAAGAATACTCAGTGGC -> CCAAGAATACTCAGTGGCA
CTGGATTGCCGTCCAGCTT -> TGGATTGCCGTCCAGCTTC
GGAAGGCTGCGACAACGTA -> GAAGGCTGCGACAACGTAC
TCTAAATGTCTGGTTTCCG -> CTAAATGTCTGGTTTCCGG
CTGCGTCTCGAAGGTCTCT -> TGCGTCTCGAAGGTCTCTT
TAGTGCTGCAGGGCTACAT -> AGTGCTGCAGGGCTACATG
CCTCTTTGAGTGCCTAGTT -> CTCTTTGAGTGCCTAGTTC
CGTTTATGCATTCGCGTCG -> GTTTATGCATTCGCGTCGA
CCGATGAGATCCGACCGGG -> CGATGAGATCCGACCGGGG
AATTACTACGAGACCCAAT -> ATTACTACGAGACCCAATT
ATGGGGCCTCGGTTTGGGG -> TGGGGCCTCGGTTTGGGGC
ACAAGAATTCCCAACACGC -> CAAGAATTCCCAACACGCA
CTTAAGACCGTCCTTCAAT -> TTAAGACCGTCCTTCAATC
CCAGTCCGGGTTAATGCGA -> CAGTCCGGGTTAATGCGAT
TAAGCAATCATGGTCAACC -> AAGCAATCATGGTCAACCG
TGACTCTCGGAACTTGTAG -> GACTCTCGGAACTTGTAGA
TCAATCGAGCTGACGCTCT -> CAATCGAGCTGACGCTCTG
TCAGGAAACGATGCGCTAA -> CAGGAAACGATGCGCTAAG
GACCGTCCTTCAATCGAGC -> ACCGTCCTTCAATCGAGCT
ACTTTAGTTCTGACTCTCG -> CTTTAGTTCTGACTCTCGG
AAGGTTCGCCGGCGGCGCT -> AGGTTCGCCGGCGGCGCTA
TCCGGAAGGCTGCGACAAC -> CCGGAAGGCTGCGACAACG
GGTCGCCTACGGCCAGGCA -> GTCGCCTACGGCCAGGCAG
CCATGGCGCTCTTTACCAT -> CATGGCGCTCTTTACCATA
CCGGCGGCGCTAAAGTCTT -> CGGCGGCGCTAAAGTCTTG
GTCGAAGGTATTAGGACCT -> TCGAAGGTATTAGGACCTT
ACAACGTACGTTCCGTGTC -> CAACGTACGTTCCGTGTCT
CGTCTATCACGGGGTCGTT -> GTCTATCACGGGGTCGTTG
ACAAAGGCGTTTATGCATT -> CAAAGGCGTTTATGCATTC
TCACATGCTTCGGATGATA -> CACATGCTTCGGATGATAA
ATTCAGAATCATAACTATT -> TTCAGAATCATAACTATTC
ATGACCTTGCATAGCTATT -> TGACCTTGCATAGCTATTT
TCCTGGCTACATTGTGTCG -> CCTGGCTACATTGTGTCGT
GTCACCGCAAGATGGACCT -> TCACCGCAAGATGGACCTT
TGCGCGTTCATGTAACCTG -> GCGCGTTCATGTAACCTGT
GCTCCCAACGTTTGTTCAC -> CTCCCAACGTTTGTTCACG
TCACTTCACCAGCGATTGG -> CACTTCACCAGCGATTGGT
GCTTAAACGTACACTCTCA -> CTTAAACGTACACTCTCAA
AGGTTGGCTGCGAAAGCTT -> GGTTGGCTGCGAAAGCTTC
GCGAACAGTACGAACCAGA -> CGAACAGTACGAACCAGAG
GACTGCGCCTCTTTGAGTG -> ACTGCGCCTCTTTGAGTGC
TTTCCGGCCCAGAACTCAT -> TTCCGGCCCAGAACTCATC
GGCGATATGCAGTACACGA -> GCGATATGCAGTACACGAT
ATTCAGGAAACGATGCGCT -> TTCAGGAAACGATGCGCTA
CGAAGGAAAAGCCAAGAAT -> GAAGGAAAAGCCAAGAATA
ACCATAAATCGGATGTCTG -> CCATAAATCGGATGTCTGT
TGGCAAAATGAGTCACATG -> GGCAAAATGAGTCACATGC
TCTCTTAATTACTACGAGA -> CTCTTAATTACTACGAGAC
GGCCATAGCTATAGGTCTG -> GCCATAGCTATAGGTCTGA
GTAAGGAGCTATGGCCTTT -> TAAGGAGCTATGGCCTTTT
GTTCCGGAGAGCGAACAGT -> TTCCGGAGAGCGAACAGTA
AACCCGGATCCTGGCTACA -> ACCCGGATCCTGGCTACAT
CTCGACTGGATAGTAGGAT -> TCGACTGGATAGTAGGATA
TACGGCCAGGCAGCGGTGC -> ACGGCCAGGCAGCGGTGCG
GCTGCGACAACGTACGTTC -> CTGCGACAACGTACGTTCC
ACACCCACGCGTTTGATGC -> CACCCACGCGTTTGATGCG
CTTCGGATGATAAAAATTG -> TTCGGATGATAAAAATTGA
TGTTCACGATCTCTTAATT -> GTTCACGATCTCTTAATTA
TGTCGAACGATGCGCTAAG -> GTCGAACGATGCGCTAAGC
GTGAACAAAGGTTCGCCGG -> TGAACAAAGGTTCGCCGGC
GAAAGCTTCGGCTTAAGAC -> AAAGCTTCGGCTTAAGACC
TCTTAATTACTACGAGACC -> CTTAATTACTACGAGACCC
AGGATAACTATTCAGAATC -> GGATAACTATTCAGAATCA
AACGGTCACCGCAAGATGG -> ACGGTCACCGCAAGATGGA
TTAGGACCTTATTTCTCTT -> TAGGACCTTATTTCTCTTG
AGTTTGGACCTTCGGCCAT -> GTTTGGACCTTCGGCCATA
CGACAACGTACGTTCCGTG -> GACAACGTACGTTCCGTGT
CCGTATTCCGTCAGTGTCA -> CGTATTCCGTCAGTGTCAG
CGTGATTGATATGTTGTAG -> GTGATTGATATGTTGTAGA
ATAGGTCTGATGTCATTGA -> TAGGTCTGATGTCATTGAG
GGCCAGGCAGCGGTGCGTT -> GCCAGGCAGCGGTGCGTTA
CATGTTCAATAGAATCTCT -> ATGTTCAATAGAATCTCTA
TTCGGCCATAGCTATGGCA -> TCGGCCATAGCTATGGCAT
CCTTTGATAGCTAACACCT -> CTTTGATAGCTAACACCTC
AGAGGTCGCCTACGGCCAG -> GAGGTCGCCTACGGCCAGG
TCGCGAGCTGCCTGTGCCT -> CGCGAGCTGCCTGTGCCTC
GTCAATAGTGCTGCAGGGC -> TCAATAGTGCTGCAGGGCT
TCCGCTATTAAGTCCGTGA -> CCGCTATTAAGTCCGTGAA
CTCATCGCGTACCTTCTGC -> TCATCGCGTACCTTCTGCG
GGATGGAGCGTGAAGTAAT -> GATGGAGCGTGAAGTAATG
ATATCGACACACCGTCAAC -> TATCGACACACCGTCAACG
TTGGGTCCTCAGTTAAGGT -> TGGGTCCTCAGTTAAGGTC
GGGTTTTACCCGGCCGTAT -> GGTTTTACCCGGCCGTATT
TTCGGATGATAAAAATTGA -> TCGGATGATAAAAATTGAA
CAGCCGCCAGCTGACGTGG -> AGCCGCCAGCTGACGTGGA
AAACCGCTATGGATGACAC -> AACCGCTATGGATGACACG
AGAACTCATCGCGTACCTT -> GAACTCATCGCGTACCTTC
TTACACATGATTTTACCGT -> TACACATGATTTTACCGTC
TGACGCTCTGGAGAAACTT -> GACGCTCTGGAGAAACTTG
TCGTAGGCGGCAACGTGGC -> CGTAGGCGGCAACGTGGCT
ATAGCTAACACCTCCCGCA -> TAGCTAACACCTCCCGCAA
ATCTCTATGGCAACGTGAT -> TCTCTATGGCAACGTGATT
GATTGCCGTCCAGCTTCTA -> ATTGCCGTCCAGCTTCTAA
CCAGCGATTGGTCATGTAC -> CAGCGATTGGTCATGTACA
AATGTAGGGAATTAACCCA -> ATGTAGGGAATTAACCCAA
GTCTGTCAGCTTGGGGATG -> TCTGTCAGCTTGGGGATGG
AACCATCGCGAGCTGCCTG -> ACCATCGCGAGCTGCCTGT
CGATTACACATGATTTTAC -> GATTACACATGATTTTACC
CGATCTCTTAATTACTACG -> GATCTCTTAATTACTACGA
GGAGAGCGAACAGTACGAA -> GAGAGCGAACAGTACGAAC
CTGTAGGCCTCTAACGCGT -> TGTAGGCCTCTAACGCGTC
ACGAGGGGGAAGTCATGGT -> CGAGGGGGAAGTCATGGTG
GGTCCTCAGTTAAGGTCGT -> GTCCTCAGTTAAGGTCGTT
GCAACCATCGCGAGCTGCC -> CAACCATCGCGAGCTGCCT
GTTCAATAGAATCTCTATG -> TTCAATAGAATCTCTATGG
TTATCCATGCAGTTCCTCT -> TATCCATGCAGTTCCTCTA
AGTGGCAAAATGAGTCACA -> GTGGCAAAATGAGTCACAT
GGTTTTACCCGGCCGTATT -> GTTTTACCCGGCCGTATTC
TCACCCGGCGGGTAATCTA -> CACCCGGCGGGTAATCTAA
AACTAACGATGCGCTAAGC -> ACTAACGATGCGCTAAGCA
ATGACAACTGGATGACCTT -> TGACAACTGGATGACCTTC
TTCCGTCGTCTGTCGAACG -> TCCGTCGTCTGTCGAACGA
TCCTTCAATCGAGCTGACG -> CCTTCAATCGAGCTGACGC
GGAACTATAGTCCGCTATT -> GAACTATAGTCCGCTATTA
AACGATGCGCTAAGCAATG -> ACGATGCGCTAAGCAATGA
ACCATCGCGAGCTGCCTGT -> CCATCGCGAGCTGCCTGTG
CCTCTCTCAGGATCGGCAG -> CTCTCTCAGGATCGGCAGC
TTATGGGGCCTCGGTTTGG -> TATGGGGCCTCGGTTTGGG
TTCAGCTTAAACGTACACT -> TCAGCTTAAACGTACACTC
GGTCTGATGTCATTGAGGG -> GTCTGATGTCATTGAGGGC
GAAGGAAAAGCCAAGAATA -> AAGGAAAAGCCAAGAATAC
TCTTTGAGTGCCTAGTTCC -> CTTTGAGTGCCTAGTTCCG
AGCTTTTCAAAATGTAGGG -> GCTTTTCAAAATGTAGGGA
GCTACATGACCTTGCATAG -> CTACATGACCTTGCATAGC
GGATGACACGAGGGGGAAG -> GATGACACGAGGGGGAAGT
GACGTGGACTGCGTCTCGA -> ACGTGGACTGCGTCTCGAA
TTGCTCGCATAAGATTTGG -> TGCTCGCATAAGATTTGGG
ATAGCTATTTTCAGCTTAA -> TAGCTATTTTCAGCTTAAA
CGCTCTTTACCATAAATCG -> GCTCTTTACCATAAATCGG
CAGGATCGGCAGCTCCCAA -> AGGATCGGCAGCTCCCAAC
ACCCGGATCCTGGCTACAT -> CCCGGATCCTGGCTACATT
TTAGTTCTGACTCTCGGAA -> TAGTTCTGACTCTCGGAAC
CCGACCTTCGGCCATAGCT -> CGACCTTCGGCCATAGCTA
AGTGCCTAGTTCCGGTTAT -> GTGCCTAGTTCCGGTTATA
TGTAGAACTCGTGGGAATA -> GTAGAACTCGTGGGAATAA
AGTCTTGTCCCAGTCCGGG -> GTCTTGTCCCAGTCCGGGT
ACTTTATCCATGCAGTTCC -> CTTTATCCATGCAGTTCCT
TTTGATGCGGGACATCAGG -> TTGATGCGGGACATCAGGC
TGTAACCTGTCAGAACGGT -> GTAACCTGTCAGAACGGTC
GCCCCCGATGAGATCCGAC -> CCCCCGATGAGATCCGACC
CTTGTAACTCTGTCGTCGT -> TTGTAACTCTGTCGTCGTC
CGGACCCGGGGGTGCCCAC -> GGACCCGGGGGTGCCCACC
GGCGCTCTTTACCATAAAT -> GCGCTCTTTACCATAAATC
GCATTCGCGTCGAAGGTAT -> CATTCGCGTCGAAGGTATT
TTAGCCTAAGAAATTCACT -> TAGCCTAAGAAATTCACTT
CCGGATCCTGGCTACATTG -> CGGATCCTGGCTACATTGT
GTCGTCTGTCGAACGATGC -> TCGTCTGTCGAACGATGCG
CTGACTGCGCCTCTTTGAG -> TGACTGCGCCTCTTTGAGT
ACGGTGGAAGCTAGTTAGC -> CGGTGGAAGCTAGTTAGCG
TCATGGTGCCCTGTGAACA -> CATGGTGCCCTGTGAACAA
CGGCCATAGCTATAGGTCT -> GGCCATAGCTATAGGTCTG
CACCCGGCGGGTAATCTAA -> ACCCGGCGGGTAATCTAAA
GCGATTACCTCGACTGGAT -> CGATTACCTCGACTGGATA
CCTACGGCCAGGCAGCGGT -> CTACGGCCAGGCAGCGGTG
GCGTCTATCACGGGGTCGT -> CGTCTATCACGGGGTCGTT
ACGCGTCTATCACGGGGTC -> CGCGTCTATCACGGGGTCG
GCAGCGGTGCGTTACGTCC -> CAGCGGTGCGTTACGTCCT
TGATAGCTAACACCTCCCG -> GATAGCTAACACCTCCCGC
GGAGCTATGGCCTTTTGAT -> GAGCTATGGCCTTTTGATG
CATCAGGCGATATGCAGTA -> ATCAGGCGATATGCAGTAC
GAGCGTGAAGTAATGGGTG -> AGCGTGAAGTAATGGGTGT
CGATTACCTCGACTGGATA -> GATTACCTCGACTGGATAG
TGGCAACGTGATTAGCCTA -> GGCAACGTGATTAGCCTAA
CAGGACCTTCGGCCATAGC -> AGGACCTTCGGCCATAGCT
CCTTCGGCCATAGCTATGG -> CTTCGGCCATAGCTATGGC
ACGTTCCGTGTCTCAACCT -> CGTTCCGTGTCTCAACCTG
ACACCACCGATTACACATG -> CACCACCGATTACACATGA
ACGGTCACCGCAAGATGGA -> CGGTCACCGCAAGATGGAC
TATATCGACACACCGTCAA -> ATATCGACACACCGTCAAC
TGATAGACTTCGAATCTGC -> GATAGACTTCGAATCTGCA
GATTGATATGTTGTAGAAC -> ATTGATATGTTGTAGAACA
GTGCCTCTCTCAGGATCGG -> TGCCTCTCTCAGGATCGGC
GGAAACGATGCGCTAAGCA -> GAAACGATGCGCTAAGCAA
TAGAATCTCTATGGCAACG -> AGAATCTCTATGGCAACGT
GTTAGCGGCCGGAAGCCAA -> TTAGCGGCCGGAAGCCAAA
AGATATCAGGGTTTTACCC -> GATATCAGGGTTTTACCCG
CCCGGCAGAGTTAGGGCAC -> CCGGCAGAGTTAGGGCACG
CGATGCGCTAAGCAATAAC -> GATGCGCTAAGCAATAACT
TTTTGTTGTGATGCGTATT -> TTTGTTGTGATGCGTATTC
TAAACGTGAGCAAGCAGAC -> AAACGTGAGCAAGCAGACT
GCTAAGCAATCATGGTCAA -> CTAAGCAATCATGGTCAAC
CCGGCAGAGTTAGGGCACG -> CGGCAGAGTTAGGGCACGA
TTCGGCCATAGCTATTTTC -> TCGGCCATAGCTATTTTCA
GACCGGGGTCCGGAAGGCT -> ACCGGGGTCCGGAAGGCTG
GATTTTACCGTCCAATGGA -> ATTTTACCGTCCAATGGAA
TCCGTCAGTGTCAGGCCCC -> CCGTCAGTGTCAGGCCCCC
CGATATGCAGTACACGATC -> GATATGCAGTACACGATCT
GTCAGTGTCAGGCCCCCGA -> TCAGTGTCAGGCCCCCGAT
ATTAACCCAACCGTCTTGG -> TTAACCCAACCGTCTTGGG
CACCCGTGTTGCGACGGAA -> ACCCGTGTTGCGACGGAAC
AATGGAAGACGGGGGTATT -> ATGGAAGACGGGGGTATTA
TAAGTGCACCGACATGCGC -> AAGTGCACCGACATGCGCG
GTGGACTGCGTCTCGAAGG -> TGGACTGCGTCTCGAAGGT
AGTTAGGGCACGAGAGACA -> GTTAGGGCACGAGAGACAG
ATAGACTTCGAATCTGCAG -> TAGACTTCGAATCTGCAGT
TTCTGCGATTACCTCGACT -> TCTGCGATTACCTCGACTG
ATCATAACTATTCGTGTTA -> TCATAACTATTCGTGTTAA
GCTATAGGTCTGATGTCAT -> CTATAGGTCTGATGTCATT
CATGCAGTTCCTCTACGGC -> ATGCAGTTCCTCTACGGCA
ACCCAACCGTCTTGGGTCC -> CCCAACCGTCTTGGGTCCT
TTGCCTGTATTCCGTAAGG -> TGCCTGTATTCCGTAAGGA
GTGTTAATCGTAGGCGGCA -> TGTTAATCGTAGGCGGCAA
CGCAAGATGGACCTTTGCT -> GCAAGATGGACCTTTGCTG
CAGACTTTATCCATGCAGT -> AGACTTTATCCATGCAGTT
GGGGGTGCCCACCGCTTGT -> GGGGTGCCCACCGCTTGTA
TATGGATGACACGAGGGGG -> ATGGATGACACGAGGGGGA
TGGTCATGTACACTAAGTG -> GGTCATGTACACTAAGTGC
GATCAGAACTCAGCCGCCA -> ATCAGAACTCAGCCGCCAG
TCAGGCGATATGCAGTACA -> CAGGCGATATGCAGTACAC
GGAAGTCATGGTGCCCTGT -> GAAGTCATGGTGCCCTGTG
AGCCAAGAATACTCAGTGG -> GCCAAGAATACTCAGTGGC
CTGACGCTCTGGAGAAACT -> TGACGCTCTGGAGAAACTT
ACCCGGCCGTATTCCGTCA -> CCCGGCCGTATTCCGTCAG
TCGTGTTAATCGTAGGCGG -> CGTGTTAATCGTAGGCGGC
GGGCTACATGACCTTGCAT -> GGCTACATGACCTTGCATA
ACAACGATGCGCTAAGCAA -> CAACGATGCGCTAAGCAAT
AAAGTCTTGTCCCAGTCCG -> AAGTCTTGTCCCAGTCCGG
ATGACACGAGGGGGAAGTC -> TGACACGAGGGGGAAGTCA
GACCTTATTTCTCTTGCTA -> ACCTTATTTCTCTTGCTAC
GCGGGACATCAGGCGATAT -> CGGGACATCAGGCGATATG
AATTGGAAGGTTTCCTAAC -> ATTGGAAGGTTTCCTAACC
TACTCAGTGGCAAAATGAG -> ACTCAGTGGCAAAATGAGT
AAGTCCGTGAAGGACTTTA -> AGTCCGTGAAGGACTTTAG
GTATTCCGTCAGTGTCAGG -> TATTCCGTCAGTGTCAGGC
TCAGTTAAGGTCGTTCGAC -> CAGTTAAGGTCGTTCGACG
CTCAGCCGCCAGCTGACGT -> TCAGCCGCCAGCTGACGTG
GCTCTTTACCATAAATCGG -> CTCTTTACCATAAATCGGA
CGTTGTTAGTTTATATTCA -> GTTGTTAGTTTATATTCAG
TCTGCGATTACCTCGACTG -> CTGCGATTACCTCGACTGG
GTGATTCCTTTGATAGCTA -> TGATTCCTTTGATAGCTAA
AAATTCACTTCACCAGCGA -> AATTCACTTCACCAGCGAT
CTTGCCTGTATTCCGTAAG -> TTGCCTGTATTCCGTAAGG
TGGACTGCGTCTCGAAGGT -> GGACTGCGTCTCGAAGGTC
ATAAAAATTGAAATGAATA -> TAAAAATTGAAATGAATAA
GACAAGAATTCCCAACACG -> ACAAGAATTCCCAACACGC
CTTCTGTGGCGACGGTGGA -> TTCTGTGGCGACGGTGGAA
ACATGCGCGTTCATGTAAC -> CATGCGCGTTCATGTAACC
CTTTGCTCGCATAAGATTT -> TTTGCTCGCATAAGATTTG
TTGATGCGGGACATCAGGC -> TGATGCGGGACATCAGGCG
GACTTCTGTGGCGACGGTG -> ACTTCTGTGGCGACGGTGG
TGGATGACACGAGGGGGAA -> GGATGACACGAGGGGGAAG
CTTCGAATCTGCAGTAGTT -> TTCGAATCTGCAGTAGTTC
ACCGGGGTCCGGAAGGCTG -> CCGGGGTCCGGAAGGCTGC
GGCGCTAAAGTCTTGTCCC -> GCGCTAAAGTCTTGTCCCA
TCTATCACGGGGTCGTTGT -> CTATCACGGGGTCGTTGTT
CTCAGGATCGGCAGCTCCC -> TCAGGATCGGCAGCTCCCA
CTAACGCGTCTATCACGGG -> TAACGCGTCTATCACGGGG
CATTGTGTCGTCTCGGTAA -> ATTGTGTCGTCTCGGTAAG
ATGTTCAATAGAATCTCTA -> TGTTCAATAGAATCTCTAT
TTCACGATCTCTTAATTAC -> TCACGATCTCTTAATTACT
GCAGTAGTTCAGGCAACCC -> CAGTAGTTCAGGCAACCCT
ATCCATGCAGTTCCTCTAC -> TCCATGCAGTTCCTCTACG
ATGAGATCCGACCGGGGTC -> TGAGATCCGACCGGGGTCC
CACGCGTTTGATGCGGGAC -> ACGCGTTTGATGCGGGACA
CGCCGGCGGCGCTAAAGTC -> GCCGGCGGCGCTAAAGTCT
CGCTATGGATGACACGAGG -> GCTATGGATGACACGAGGG
GGCTGCGACAACGTACGTT -> GCTGCGACAACGTACGTTC
TGAAGTAATGGGTGTAGAA -> GAAGTAATGGGTGTAGAAC
AAGCCAGACTGATAGACTT -> AGCCAGACTGATAGACTTC
ATACGCTATATATCGACAC -> TACGCTATATATCGACACA
GTCGAACGATGCGCTAAGC -> TCGAACGATGCGCTAAGCA
CAGCGGTGCGTTACGTCCT -> AGCGGTGCGTTACGTCCTT
TCAACCGACCTTCGGCCAT -> CAACCGACCTTCGGCCATA
TACACATGATTTTACCGTC -> ACACATGATTTTACCGTCC
GTTCGCCGGCGGCGCTAAA -> TTCGCCGGCGGCGCTAAAG
TTGACTAAACGTGAGCAAG -> TGACTAAACGTGAGCAAGC
CACCACCGATTACACATGA -> ACCACCGATTACACATGAT
CGAAAGCTTCGGCTTAAGA -> GAAAGCTTCGGCTTAAGAC
AACGTACGTTCCGTGTCTC -> ACGTACGTTCCGTGTCTCA
CAGCTTAAACGTACACTCT -> AGCTTAAACGTACACTCTC
TTGGACCTTCGGCCATAGC -> TGGACCTTCGGCCATAGCT
GTCGTTCGACGAAGGAAAA -> TCGTTCGACGAAGGAAAAG
CTCTTATGGGGCCTCGGTT -> TCTTATGGGGCCTCGGTTT
TTTGCTTGCCTGTATTCCG -> TTGCTTGCCTGTATTCCGT
TGACAAAGGCGTTTATGCA -> GACAAAGGCGTTTATGCAT
CTACAATCACCCGTGTTGC -> TACAATCACCCGTGTTGCG
CTACATTGTGTCGTCTCGG -> TACATTGTGTCGTCTCGGT
AGATCCGACCGGGGTCCGG -> GATCCGACCGGGGTCCGGA
TGGTGCCCTGTGAACAAAG -> GGTGCCCTGTGAACAAAGG
TAACGCGTCTATCACGGGG -> AACGCGTCTATCACGGGGT
TCTTGTCCCAGTCCGGGTT -> CTTGTCCCAGTCCGGGTTA
ATGGACCTTTGCTGACACC -> TGGACCTTTGCTGACACCA
AGAATCATAACTATTCGTG -> GAATCATAACTATTCGTGT
CGGCAACGTGGCTAAATTA -> GGCAACGTGGCTAAATTAA
GTTCCTCTACGGCAATACG -> TTCCTCTACGGCAATACGC
ATGTACACTAAGTGCACCG -> TGTACACTAAGTGCACCGA
ATCACGGGGTCGTTGTTAG -> TCACGGGGTCGTTGTTAGT
AAATGGACAAGAATTCCCA -> AATGGACAAGAATTCCCAA
TTGGGACTTCTGTGGCGAC -> TGGGACTTCTGTGGCGACG
CGATGCGCTAAGCAATTAG -> GATGCGCTAAGCAATTAGG
TTGTGTCGTCTCGGTAAGA -> TGTGTCGTCTCGGTAAGAT
CTTTTCAAAATGTAGGGAA -> TTTTCAAAATGTAGGGAAT
CGGTGGAAGCTAGTTAGCG -> GGTGGAAGCTAGTTAGCGG
TGCCTCTCTCAGGATCGGC -> GCCTCTCTCAGGATCGGCA
GCTATCCATGGCGCTCTTT -> CTATCCATGGCGCTCTTTA
CCGGGGTCCGGAAGGCTGC -> CGGGGTCCGGAAGGCTGCG
TTTGCTCGCATAAGATTTG -> TTGCTCGCATAAGATTTGG
GCATAGCCTAAATGGACAA -> CATAGCCTAAATGGACAAG
GGATCCTGGCTACATTGTG -> GATCCTGGCTACATTGTGT
GGGGCCAAACGTCCCCGTG -> GGGCCAAACGTCCCCGTGA
GGCAATACGCTATATATCG -> GCAATACGCTATATATCGA
CACGAGAGACAGGGGGTGC -> ACGAGAGACAGGGGGTGCC
TCGAATCTGCAGTAGTTCA -> CGAATCTGCAGTAGTTCAG
ACGGGGTCGTTGTTAGTTT -> CGGGGTCGTTGTTAGTTTA
TCGAACGATGCGCTAAGCA -> CGAACGATGCGCTAAGCAA
TCGCGTACCTTCTGCGATT -> CGCGTACCTTCTGCGATTA
AGGACCTTATTTCTCTTGC -> GGACCTTATTTCTCTTGCT
CTCGCATAAGATTTGGGAC -> TCGCATAAGATTTGGGACT
TACTTTGCTCGCATAAGAT -> ACTTTGCTCGCATAAGATT
CAACACGCAGAGGTCGCCT -> AACACGCAGAGGTCGCCTA
TGATGTCATTGAGGGCAAG -> GATGTCATTGAGGGCAAGG
GCGTCGAAGGTATTAGGAC -> CGTCGAAGGTATTAGGACC
TTTACCCGGCCGTATTCCG -> TTACCCGGCCGTATTCCGT
CTCAATGGCATCGAGGACA -> TCAATGGCATCGAGGACAA
CAGTAGTTCAGGCAACCCT -> AGTAGTTCAGGCAACCCTG
TTTATCCATGCAGTTCCTC -> TTATCCATGCAGTTCCTCT
TCAAAATGTAGGGAATTAA -> CAAAATGTAGGGAATTAAC
TAAAAATTGAAATGAATAA -> AAAAATTGAAATGAATAAC
GGTGGAAGCTAGTTAGCGG -> GTGGAAGCTAGTTAGCGGC
TCCAGCTTCTAAATGTCTG -> CCAGCTTCTAAATGTCTGG
GTAGGCCTCTAACGCGTCT -> TAGGCCTCTAACGCGTCTA
GGGTCCGGAAGGCTGCGAC -> GGTCCGGAAGGCTGCGACA
ACACACCGTCAACGTGATT -> CACACCGTCAACGTGATTC
TCTGGTTTCCGGCCCAGAA -> CTGGTTTCCGGCCCAGAAC
GGGGTGCCCACCGCTTGTA -> GGGTGCCCACCGCTTGTAA
GTTCACGATCTCTTAATTA -> TTCACGATCTCTTAATTAC
ATATGCAGTACACGATCTA -> TATGCAGTACACGATCTAC
ACTCGTGGGAATAAAATTC -> CTCGTGGGAATAAAATTCC
TCCCCGTGATTGATATGTT -> CCCCGTGATTGATATGTTG
AAGGTCGTTCGACGAAGGA -> AGGTCGTTCGACGAAGGAA
GCTATTTGCTTGCCTGTAT -> CTATTTGCTTGCCTGTATT
ATTTCTCTTGCTACAATCA -> TTTCTCTTGCTACAATCAC
CACCTCCCGCAACCATCGC -> ACCTCCCGCAACCATCGCG
TGGGAATAAAATTCCGTCG -> GGGAATAAAATTCCGTCGT
GAGCAAGCAGACTTTATCC -> AGCAAGCAGACTTTATCCA
GTTGCGACGGAACTATAGT -> TTGCGACGGAACTATAGTC
CAATACGCTATATATCGAC -> AATACGCTATATATCGACA
GTCGTCAATAGTGCTGCAG -> TCGTCAATAGTGCTGCAGG
ATTGTGTCGTCTCGGTAAG -> TTGTGTCGTCTCGGTAAGA
CGTGTCTCAACCTGAACTA -> GTGTCTCAACCTGAACTAA
GCTGACACCACCGATTACA -> CTGACACCACCGATTACAC
GGGTTCCGGAGAGCGAACA -> GGTTCCGGAGAGCGAACAG
CGAACCAGAGCGAAGCCAG -> GAACCAGAGCGAAGCCAGA
TCATGTAACCTGTCAGAAC -> CATGTAACCTGTCAGAACG
GATAAAAATTGAAATGAAT -> ATAAAAATTGAAATGAATA
CGAAGGTCTCTTATGGGGC -> GAAGGTCTCTTATGGGGCC
TCGAAGGTATTAGGACCTT -> CGAAGGTATTAGGACCTTA
GGGCAAGGGCTATCCATGG -> GGCAAGGGCTATCCATGGC
AGACTGATAGACTTCGAAT -> GACTGATAGACTTCGAATC
TGGATGACCTTCGGCCATA -> GGATGACCTTCGGCCATAG
AAGGCTGCGACAACGTACG -> AGGCTGCGACAACGTACGT
AATCTAAACCCGGATCCTG -> ATCTAAACCCGGATCCTGG
GGTATTAGGACCTTATTTC -> GTATTAGGACCTTATTTCT
GCCATAGCTATGGCATGTT -> CCATAGCTATGGCATGTTC
GCGACGGAACTATAGTCCG -> CGACGGAACTATAGTCCGC
TTAGTTTATATTCAGGAAA -> TAGTTTATATTCAGGAAAC
TGGACAAGAATTCCCAACA -> GGACAAGAATTCCCAACAC
ACGGCAATACGCTATATAT -> CGGCAATACGCTATATATC
AAGCTTTTCAAAATGTAGG -> AGCTTTTCAAAATGTAGGG
GTTTGATGCGGGACATCAG -> TTTGATGCGGGACATCAGG
CAATAGAATCTCTATGGCA -> AATAGAATCTCTATGGCAA
GATCAACACCCACGCGTTT -> ATCAACACCCACGCGTTTG
CGGAAGGCTGCGACAACGT -> GGAAGGCTGCGACAACGTA
ACCTCGACTGGATAGTAGG -> CCTCGACTGGATAGTAGGA
TAGCTATTTTCAGCTTAAA -> AGCTATTTTCAGCTTAAAC
TGGTTTCCGGCCCAGAACT -> GGTTTCCGGCCCAGAACTC
ACGTGATTAGCCTAAGAAA -> CGTGATTAGCCTAAGAAAT
GCTAACACCTCCCGCAACC -> CTAACACCTCCCGCAACCA
TCAACGTGATTCCTTTGAT -> CAACGTGATTCCTTTGATA
TCAACCTGAACTAACGATG -> CAACCTGAACTAACGATGC
ATGTAGGGAATTAACCCAA -> TGTAGGGAATTAACCCAAC
CTTTACCATAAATCGGATG -> TTTACCATAAATCGGATGT
TAGGTCTGATGTCATTGAG -> AGGTCTGATGTCATTGAGG
GGACCCGGGGGTGCCCACC -> GACCCGGGGGTGCCCACCG
CGGGTTAATGCGATCAACA -> GGGTTAATGCGATCAACAC
GAAGGTTTCCTAACCTTAT -> AAGGTTTCCTAACCTTATG
GTTATAAACCGCTATGGAT -> TTATAAACCGCTATGGATG
GAACTCAGCCGCCAGCTGA -> AACTCAGCCGCCAGCTGAC
ATAACGGGTTCCGGAGAGC -> TAACGGGTTCCGGAGAGCG
CCAAGAATACTCAGTGGCA -> CAAGAATACTCAGTGGCAA
GGCCCAGAACTCATCGCGT -> GCCCAGAACTCATCGCGTA
CCCAACCTGTAGGCCTCTA -> CCAACCTGTAGGCCTCTAA
TTTGAGTGCCTAGTTCCGG -> TTGAGTGCCTAGTTCCGGT
ACCTTCGGCCATAGCTATC -> CCTTCGGCCATAGCTATCC
TGTTGTAGAACAACGATGC -> GTTGTAGAACAACGATGCG
CCCAACCGTCTTGGGTCCT -> CCAACCGTCTTGGGTCCTC
GCAAGCAGACTTTATCCAT -> CAAGCAGACTTTATCCATG
TATTTGCTTGCCTGTATTC -> ATTTGCTTGCCTGTATTCC
CCATAGCTATTTTCAGCTT -> CATAGCTATTTTCAGCTTA
GAAAAGCCAAGAATACTCA -> AAAAGCCAAGAATACTCAG
CCGTCCTTCAATCGAGCTG -> CGTCCTTCAATCGAGCTGA
GGAGCGTGAAGTAATGGGT -> GAGCGTGAAGTAATGGGTG
GCTAAAGTCTTGTCCCAGT -> CTAAAGTCTTGTCCCAGTC
AAATGAGTCACATGCTTCG -> AATGAGTCACATGCTTCGG
GTGGCAAAATGAGTCACAT -> TGGCAAAATGAGTCACATG
AATCGAGCTGACGCTCTGG -> ATCGAGCTGACGCTCTGGA
AGCGTGAAGTAATGGGTGT -> GCGTGAAGTAATGGGTGTA
CAACTGGATGACCTTCGGC -> AACTGGATGACCTTCGGCC
TATTTCTCTTGCTACAATC -> ATTTCTCTTGCTACAATCA
CGACGAAGGAAAAGCCAAG -> GACGAAGGAAAAGCCAAGA
CAACGTGATTAGCCTAAGA -> AACGTGATTAGCCTAAGAA
ATATTCAGGAAACGATGCG -> TATTCAGGAAACGATGCGC
CTAAACGTGAGCAAGCAGA -> TAAACGTGAGCAAGCAGAC
TGCTTCGGATGATAAAAAT -> GCTTCGGATGATAAAAATT
CACGATCTACTTTGCTCGC -> ACGATCTACTTTGCTCGCA
GGTTTCCTAACCTTATGAC -> GTTTCCTAACCTTATGACA
AGGGCTACATGACCTTGCA -> GGGCTACATGACCTTGCAT
GAGCGAACAGTACGAACCA -> AGCGAACAGTACGAACCAG
TGCATTCGCGTCGAAGGTA -> GCATTCGCGTCGAAGGTAT
TCAGGATCGGCAGCTCCCA -> CAGGATCGGCAGCTCCCAA
TTGTTAGTTTATATTCAGG -> TGTTAGTTTATATTCAGGA
TGTGCCTCTCTCAGGATCG -> GTGCCTCTCTCAGGATCGG
CCTTCTGCGATTACCTCGA -> CTTCTGCGATTACCTCGAC
CCATAAATCGGATGTCTGT -> CATAAATCGGATGTCTGTC
TAGGCGGTCAGGACCTTCG -> AGGCGGTCAGGACCTTCGG
ATTCCGTAAGGAGCTATGG -> TTCCGTAAGGAGCTATGGC
CTAAGCAATCATGGTCAAC -> TAAGCAATCATGGTCAACC
CGGAAGCCAAATTTTGTTG -> GGAAGCCAAATTTTGTTGT
GCAGTTCCTCTACGGCAAT -> CAGTTCCTCTACGGCAATA
CTAAATTAAGCTTTTCAAA -> TAAATTAAGCTTTTCAAAA
GCCTAGTTCCGGTTATAAA -> CCTAGTTCCGGTTATAAAC
GTATTCCGTAAGGAGCTAT -> TATTCCGTAAGGAGCTATG
CGCTAAGCAATAACTAAGT -> GCTAAGCAATAACTAAGTT
ATTAAGTCCGTGAAGGACT -> TTAAGTCCGTGAAGGACTT
GACATGCGCGTTCATGTAA -> ACATGCGCGTTCATGTAAC
TAAACCGCTATGGATGACA -> AAACCGCTATGGATGACAC
GCTTCGGCTTAAGACCGTC -> CTTCGGCTTAAGACCGTCC
ACGTGATTCCTTTGATAGC -> CGTGATTCCTTTGATAGCT
TAGCGGCCGGAAGCCAAAT -> AGCGGCCGGAAGCCAAATT
GACCCAATTGGAAGGTTTC -> ACCCAATTGGAAGGTTTCC
GAAACTTGAGTTTATGAGC -> AAACTTGAGTTTATGAGCC
ATGAATAACGGGTTCCGGA -> TGAATAACGGGTTCCGGAG
CTATTTTCAGCTTAAACGT -> TATTTTCAGCTTAAACGTA
AGGGCACGAGAGACAGGGG -> GGGCACGAGAGACAGGGGG
CCGTCTTGGGTCCTCAGTT -> CGTCTTGGGTCCTCAGTTA
CGTCCCCGTGATTGATATG -> GTCCCCGTGATTGATATGT
TCCGGAGAGCGAACAGTAC -> CCGGAGAGCGAACAGTACG
GCGAAGCCAGACTGATAGA -> CGAAGCCAGACTGATAGAC
TCAATAGAATCTCTATGGC -> CAATAGAATCTCTATGGCA
AATTAACCCAACCGTCTTG -> ATTAACCCAACCGTCTTGG
ATCAACACCCACGCGTTTG -> TCAACACCCACGCGTTTGA
GGTCGTTGTTAGTTTATAT -> GTCGTTGTTAGTTTATATT
GGGTAATCTAAACCCGGAT -> GGTAATCTAAACCCGGATC
CTCGGTTTGGGGCCAAACG -> TCGGTTTGGGGCCAAACGT
CTGATAGACTTCGAATCTG -> TGATAGACTTCGAATCTGC
TTAAACGTACACTCTCAAT -> TAAACGTACACTCTCAATG
CTCTGTCGTCGTCAATAGT -> TCTGTCGTCGTCAATAGTG
AACACGCAGAGGTCGCCTA -> ACACGCAGAGGTCGCCTAC
GTTCAGGCAACCCTGACTG -> TTCAGGCAACCCTGACTGC
TAGAACAACGATGCGCTAA -> AGAACAACGATGCGCTAAG
